sex,Age,Married,Number_children,education_level,total_members,income,Happy?,gained_asset,durable_asset,save_asset,Total Asset,living_expenses,other_expenses,Total Expenses,depressed
1,28,1,4,10,5,30028818,0,28912201,22861940,23399979,75174120,26692283,28203066,54895349,0
1,23,1,3,8,5,30028818,1,28912201,22861940,23399979,75174120,26692283,28203066,54895349,1
1,22,1,3,9,5,30028818,0,28912201,22861940,23399979,75174120,26692283,28203066,54895349,0
1,27,1,2,10,4,22288055,0,52667108,19698904,49647648,122013660,397715,44042267,44439982,0
0,59,0,4,10,6,53384566,0,82606287,17352654,23399979,123358920,80877619,74503502,155381121,0
1,35,1,6,10,8,22688441,0,35937466,736707,23399979,60074152,30696127,11531066,42227193,0
0,34,0,1,9,3,26692283,1,41303144,21925041,23399979,86628164,66730708,10890451,77621159,1
1,21,1,2,10,4,9275569,0,12013633,20323505,48046108,80383246,80076849,58456101,138532950,0
1,32,1,7,9,9,32564587,0,11087568,25224208,80076851,116388627,30162281,67184479,97346760,0
1,29,1,4,10,5,30028818,0,28912201,22861940,23399979,75174120,26692283,28203066,54895349,0
1,84,0,0,1,5,30028818,1,28912201,22861940,23399979,75174120,26692283,28203066,54895349,1
1,59,0,2,9,3,66730709,0,1018915,47245342,23399979,71664236,262919,30108896,30371815,0
1,38,1,4,10,6,72069163,0,12390944,19186414,23399979,54977337,10810375,498078,11308453,0
1,27,1,4,10,6,3109651,0,16521259,37155658,23399979,77076896,21220366,10506083,31726449,0
1,56,1,0,12,2,43775349,1,93596368,21140288,5925687,120662343,34566505,72469551,107036056,1
1,24,1,2,10,5,21353827,0,1108353,12219727,1601537,14929617,38169963,37860336,76030299,0
1,25,1,3,10,5,6406148,0,37172832,75432396,80076847,192682075,40705733,40278656,80984389,0
1,44,1,5,12,5,30028818,0,28912201,22861940,23399979,75174120,26692283,28203066,54895349,0
1,32,1,4,9,5,30028818,0,28912201,22861940,23399979,75174120,26692283,28203066,54895349,0
1,26,1,2,7,4,42707653,0,82606287,20419597,23399979,126425863,25357668,99295292,124652960,0
1,40,0,0,7,5,30028818,1,28912201,22861940,23399979,75174120,26692283,28203066,54895349,1
1,55,0,0,6,1,48046109,1,17142671,83440079,24023056,124605806,16495831,42985252,59481083,1
1,34,1,3,10,5,30028818,0,28912201,1905829,23399979,54218009,49380727,30221003,79601730,0
1,43,1,4,4,9,58322639,1,12390944,18978214,80076847,111446005,18684598,23542593,42227191,1
1,51,1,2,12,5,30028818,1,28912201,22861940,23399979,75174120,26692283,28203066,54895349,1
1,28,1,3,10,5,92088375,0,75696259,46604727,23399979,145700965,53384566,67264552,120649118,0
1,53,1,4,9,5,30028818,0,28912201,22861940,23399979,75174120,26692283,28203066,54895349,0
1,26,1,3,11,5,44042268,0,37172832,27146051,23399979,87718862,15481524,41639961,57121485,0
1,23,1,2,8,5,30028818,0,28912201,22861940,23399979,75174120,26692283,28203066,54895349,0
1,36,1,5,12,5,30028818,0,28912201,22861940,23399979,75174120,26692283,28203066,54895349,0
1,27,1,3,8,5,30028818,0,28912201,22861940,23399979,75174120,26692283,28203066,54895349,0
1,44,0,3,8,4,80076847,0,53694088,44843037,24023056,122560181,30696127,39557964,70254091,0
0,40,1,5,11,9,25144131,0,24781887,51393323,23399979,99575189,60057635,28909344,88966979,0
1,19,1,2,10,5,30028818,0,28912201,22861940,23399979,75174120,26692283,28203066,54895349,0
1,27,1,3,8,5,93422985,0,82477118,21941057,80076847,184495022,77407622,15086478,92494100,0
1,31,1,2,10,4,1134422,0,20651573,3119794,32030739,55802106,11611143,28026898,39638041,0
1,27,1,3,10,5,28827665,0,28912201,68065323,23399979,120377503,28694205,52049952,80744157,0
1,27,1,4,8,6,3203074,0,11151849,17360661,11210759,39723269,48046112,28187052,76233164,0
0,35,0,0,13,5,30028818,0,28912201,22861940,23399979,75174120,26692283,28203066,54895349,0
1,43,0,2,1,4,18417675,1,41303144,14093526,23399979,78796649,37369196,88084536,125453732,1
1,22,1,2,10,5,30028818,0,28912201,22861940,23399979,75174120,26692283,28203066,54895349,0
1,41,1,6,10,8,14914313,0,86736603,13677126,23399979,123813708,41373043,16623955,57996998,0
1,20,1,2,9,5,30028818,1,28912201,22861940,23399979,75174120,26692283,28203066,54895349,1
1,18,1,2,9,3,64061481,0,22375139,16816139,40038424,79229702,26158438,3867712,30026150,0
1,38,1,5,9,8,10276529,0,10429825,12892372,23399979,46722176,25357668,87283764,112641432,0
0,24,0,2,7,5,30028818,0,28912201,22861940,23399979,75174120,26692283,28203066,54895349,0
1,26,1,1,8,3,28026898,0,22375139,17616907,23399979,63392025,13346142,86483002,99829144,0
1,26,1,3,6,5,30028818,1,28912201,22861940,23399979,75174120,26692283,28203066,54895349,1
1,37,1,5,10,8,41639962,1,47847064,59609204,1601537,109057805,15881909,81838539,97720448,1
1,23,1,4,14,6,21353827,1,82606287,59625221,23399979,165631487,66730708,17616907,84347615,1
1,28,0,4,10,5,10009606,0,57142133,25064053,14413834,96620020,36034582,15695063,51729645,0
1,19,1,1,7,3,30028818,0,22375139,20819981,23399979,66595099,66730708,23382441,90113149,0
1,35,1,3,9,5,26692283,0,41303144,37556042,23399979,102259165,20019212,32030739,52049951,0
1,53,1,3,8,5,30028818,0,28912201,22861940,23399979,75174120,26692283,28203066,54895349,0
1,33,1,3,9,5,30028818,0,28912201,22861940,23399979,75174120,26692283,28203066,54895349,0
1,19,1,2,6,4,24023056,0,41303144,13372833,23399979,78075956,26692283,42280579,68972862,0
1,26,1,3,10,5,33365355,0,28912201,18417676,23399979,70729856,53384566,38757195,92141761,0
1,26,1,5,8,7,10743644,0,42236978,19698904,23399979,85335861,10676913,16976292,27653205,0
1,49,0,1,14,2,33365355,0,82606287,17616907,19218445,119441639,24690363,19762967,44453330,0
1,20,1,1,8,5,30028818,0,28912201,22861940,23399979,75174120,26692283,28203066,54895349,0
0,48,0,5,9,6,19351906,1,17142671,12235743,23399979,52778393,26692283,18097368,44789651,1
1,28,1,3,10,7,80076847,0,28912201,17696983,23399979,70009163,46711496,10217806,56929302,0
1,21,1,1,10,3,26692283,0,27572495,27226129,23399979,78198603,30696127,26905821,57601948,0
1,42,1,0,9,3,11184067,0,52253772,26745667,12812296,91811735,62193022,57735409,119928431,0
1,46,0,0,1,1,64061481,0,22375139,52690567,22421518,97487224,34032662,90486841,124519503,0
1,24,1,2,9,4,84080696,0,61954716,16175523,23399979,101530218,77407622,45355526,122763148,0
1,30,1,2,10,4,50181494,0,41303146,16335678,32030739,89669563,48179574,41736053,89915627,0
1,45,1,4,9,4,66730708,0,49563774,20163351,17671359,87398484,15614985,2234144,17849129,0
1,25,1,4,10,6,66063399,1,20651573,35393967,24023054,80068594,3203074,3411274,6614348,1
0,19,1,1,10,5,30028818,1,28912201,22861940,23399979,75174120,26692283,28203066,54895349,1
1,45,1,3,8,5,13346142,0,28912201,96092216,23399979,148404396,21353827,19218444,40572271,0
1,40,0,1,5,3,50715337,0,28912201,18337599,23399979,70649779,46711496,14894294,61605790,0
0,37,0,0,12,5,30028818,1,28912201,22861940,23399979,75174120,26692283,28203066,54895349,1
1,21,1,1,7,5,30028818,1,28912201,22861940,23399979,75174120,26692283,28203066,54895349,1
1,30,1,6,7,8,21353827,1,6712542,28347205,23399979,58459726,66730708,34593201,101323909,1
1,25,1,1,7,3,30028818,0,28912201,25224208,23399979,77536388,93422991,481422,93904413,0
1,38,1,3,13,5,30028818,0,28912201,22861940,23399979,75174120,26692283,28203066,54895349,0
1,48,1,0,1,2,30028818,1,28912201,86162689,23399979,138474869,23355746,28026898,51382644,1
1,30,1,4,11,6,22021134,0,82606287,20980135,23399979,126986401,12411911,3203074,15614985,0
1,26,1,5,9,7,85415304,0,22925111,24791792,23399979,71116882,23355746,32911587,56267333,0
1,37,1,8,10,10,30028818,0,13080371,16816139,23399979,53296489,16082102,20819981,36902083,0
0,28,1,1,10,3,72069163,1,41303144,41800116,23399979,106503239,20286135,36354889,56641024,1
0,30,0,2,10,3,56053793,0,41303144,44202423,23399979,108905546,10009606,11531066,21540672,0
0,25,1,1,8,3,13346142,1,28912201,12091605,23399979,64403785,26692283,172966,26865249,1
1,55,1,2,8,5,30028818,0,28912201,22861940,23399979,75174120,26692283,28203066,54895349,0
1,38,1,5,8,7,10943837,0,28912201,44042267,23399979,96354447,80076849,13933372,94010221,0
1,43,1,5,8,5,30028818,1,28912201,22861940,23399979,75174120,26692283,28203066,54895349,1
1,32,0,2,10,3,10276529,0,16521257,31229971,40038424,87789652,10143068,30669434,40812502,0
1,23,1,3,8,5,26692283,0,28912201,64862251,12812296,106586748,12011528,22581671,34593199,0
1,35,1,2,6,4,12812296,1,67399603,27786667,32030739,127217009,3203074,17937214,21140288,1
1,22,1,3,7,6,48179574,0,21617699,13452911,23399979,58470589,15267985,99295292,114563277,0
1,52,1,3,1,7,53384566,0,41823944,12812296,23399979,78036219,26692283,70467629,97159912,0
0,43,0,0,6,5,30028818,1,28912201,22861940,23399979,75174120,26692283,28203066,54895349,1
1,25,1,2,10,5,14747486,0,99127548,29067896,3203074,131398518,16682677,45884033,62566710,0
1,40,0,2,10,4,80076847,0,57824402,16287631,25624592,99736625,66730708,3763612,70494320,0
1,20,1,3,10,5,30028818,0,28912201,22861940,23399979,75174120,26692283,28203066,54895349,0
1,26,1,2,9,4,93422985,0,75386055,18657906,23399979,117443940,13346142,5925687,19271829,0
1,32,0,3,7,5,10096356,1,28912201,87283768,32030739,148226708,10863759,24807808,35671567,1
1,22,1,2,10,5,30028818,0,28912201,22861940,23399979,75174120,26692283,28203066,54895349,0
1,27,1,2,10,5,30028818,0,28912201,22861940,23399979,75174120,26692283,28203066,54895349,0
1,22,1,1,12,3,13346142,0,28912201,37828305,23399979,90140485,10676913,13933372,24610285,0
1,39,0,6,9,7,3203074,0,99127548,33071738,44843035,177042321,34032662,39718117,73750779,0
1,24,1,2,4,4,86749923,1,16521257,20259444,1601537,38382238,24690363,24263285,48953648,1
1,31,0,3,10,5,48046112,0,36350497,44843036,23399979,104593512,14013449,30108896,44122345,0
1,23,1,3,9,5,30028818,0,28912201,22861940,23399979,75174120,26692283,28203066,54895349,0
1,23,1,2,8,4,12812296,0,19207828,14557971,23399979,57165778,51382647,34593201,85975848,0
0,42,0,3,14,4,40038424,1,16521257,11739266,23399979,51660502,14547294,11611143,26158437,1
1,48,1,7,4,9,20085943,1,59411945,26905823,23399979,109717747,93422985,5925687,99348672,1
0,25,1,0,10,2,42707653,0,28912201,67264557,23399979,119576737,80076849,43241501,123318350,0
1,26,1,5,7,5,30028818,0,28912201,22861940,23399979,75174120,26692283,28203066,54895349,0
1,17,1,2,9,5,30028818,0,28912201,22861940,23399979,75174120,26692283,28203066,54895349,0
1,33,1,7,9,5,30028818,0,28912201,22861940,23399979,75174120,26692283,28203066,54895349,0
1,19,1,3,11,7,30028818,0,96143182,17136445,23399979,136679606,17383348,79756546,97139894,0
1,45,1,6,11,5,30028818,0,28912201,22861940,23399979,75174120,26692283,28203066,54895349,0
1,57,0,0,6,5,30028818,0,28912201,22861940,23399979,75174120,26692283,28203066,54895349,0
1,52,1,2,9,5,30028818,0,28912201,22861940,23399979,75174120,26692283,28203066,54895349,0
1,28,1,4,9,6,25624592,1,17142671,46444572,23399979,86987222,26692283,22101212,48793495,1
1,27,1,2,18,4,21353827,1,57824402,38677118,23399979,119901499,13346142,44010239,57356381,1
1,37,1,4,9,7,56053796,1,86736603,60538097,23399979,170674679,41373043,24631639,66004682,1
1,35,1,8,10,10,50715339,0,35111401,24026257,23399979,82537637,35367274,65983322,101350596,0
1,36,0,7,10,10,64595327,0,40067783,29180005,12812296,82060084,20019212,2898782,22917994,0
0,53,0,0,8,1,32698047,0,90183739,10201791,23399979,123785509,73403776,2057975,75461751,0
1,43,1,6,13,5,30028818,1,28912201,22861940,23399979,75174120,26692283,28203066,54895349,1
1,39,1,3,10,5,30028818,0,28912201,22861940,23399979,75174120,26692283,28203066,54895349,0
1,26,1,5,9,7,29628434,0,6608503,49887878,23399979,79896360,40038425,12684173,52722598,0
1,25,1,3,10,5,30028818,0,28912201,32030739,23399979,84342919,1601537,49199215,50800752,0
1,19,1,2,12,4,36034582,0,26505453,96092216,23399979,145997648,32698047,1145099,33843146,0
1,27,1,4,10,7,16682676,0,81923103,10570144,48046112,140539359,30295742,41239578,71535320,0
1,28,0,3,9,4,45376883,0,24781887,18737982,23399979,66919848,18684598,16848169,35532767,0
1,25,1,2,9,4,42707653,0,16521257,10679049,23399979,50600285,10276529,80076847,90353376,0
1,48,0,4,9,8,74738393,1,82606287,52850719,23399979,158856985,60057635,20980135,81037770,1
1,27,1,1,12,5,30028818,0,28912201,22861940,23399979,75174120,26692283,28203066,54895349,0
1,24,1,1,10,3,37369196,0,82606287,98494522,23399979,204500788,1134422,10970528,12104950,0
1,63,1,0,1,5,30028818,0,28912201,22861940,23399979,75174120,26692283,28203066,54895349,0
1,45,0,0,7,5,30028818,0,28912201,22861940,23399979,75174120,26692283,28203066,54895349,0
1,18,1,2,10,3,30028818,0,26505453,7527224,35233814,69266491,45376882,52930798,98307680,0
1,62,1,3,9,5,3203074,0,17142671,45163342,23399979,85705992,73403783,23542593,96946376,0
1,60,0,1,1,2,16015369,0,33042515,37475967,23399979,93918461,62726867,27706591,90433458,0
1,26,1,2,8,5,30028818,1,28912201,22861940,23399979,75174120,26692283,28203066,54895349,1
0,30,1,4,10,5,30028818,0,28912201,22861940,23399979,75174120,26692283,28203066,54895349,0
1,32,1,6,9,5,30028818,0,28912201,22861940,23399979,75174120,26692283,28203066,54895349,0
1,69,0,1,6,2,16682677,0,28912201,53971798,1601537,84485536,12144989,29292112,41437101,0
1,29,1,5,9,5,30028818,0,28912201,22861940,23399979,75174120,26692283,28203066,54895349,0
0,75,0,0,4,1,30028818,0,28912201,28827665,23399979,81139845,26692283,1601537,28293820,0
1,30,1,3,13,5,30028818,0,28912201,22861940,23399979,75174120,26692283,28203066,54895349,0
0,55,0,2,12,5,30028818,0,28912201,22861940,23399979,75174120,26692283,28203066,54895349,0
1,29,1,2,10,4,33365355,1,388964,44122345,22421518,66932827,13346142,85522079,98868221,1
1,23,0,3,8,4,66730708,0,20651573,26265207,23399979,70316759,33365355,12892373,46257728,0
1,74,1,4,1,5,30028818,1,28912201,22861940,23399979,75174120,26692283,28203066,54895349,1
1,24,1,2,14,4,30028818,0,28912201,10249837,23399979,62562017,13346142,7703393,21049535,0
1,21,1,3,9,5,30028818,0,28912201,22861940,23399979,75174120,26692283,28203066,54895349,0
1,19,1,1,9,3,33365355,0,38415656,27386282,23399979,89201917,80076847,3411274,83488121,0
1,46,1,2,12,5,30028818,0,28912201,22861940,23399979,75174120,26692283,28203066,54895349,0
1,62,1,7,1,5,30028818,0,28912201,22861940,23399979,75174120,26692283,28203066,54895349,0
1,34,1,6,10,8,37369196,1,45644662,2857142,80076851,128578655,36034584,47245342,83279926,1
1,20,1,2,7,4,53384566,0,45433456,1712043,20819981,67965480,37369196,55813564,93182760,0
1,34,1,3,9,5,30028818,0,28912201,22861940,23399979,75174120,26692283,28203066,54895349,0
1,27,1,5,10,5,30028818,0,28912201,22861940,23399979,75174120,26692283,28203066,54895349,0
1,27,1,3,12,5,30028818,0,28912201,22861940,23399979,75174120,26692283,28203066,54895349,0
1,20,1,3,10,5,40038424,0,75386055,14418638,23399979,113204672,13346142,1473414,14819556,0
1,25,1,4,14,5,30028818,0,28912201,22861940,23399979,75174120,26692283,28203066,54895349,0
1,69,1,3,7,6,56053796,0,65334448,29212036,16015369,110561853,17883829,31870586,49754415,0
1,48,0,5,8,8,20019212,1,82606287,10810374,23399979,116816640,19351906,93689919,113041825,1
1,37,1,7,10,9,65396094,0,22684436,44602805,18257523,85544764,20019212,21140289,41159501,0
1,22,1,3,9,5,98761451,0,5714122,19570782,23399979,48684883,30028818,81678391,111707209,0
1,19,1,1,10,3,49380727,0,41303144,15775139,23399979,80478262,80076847,39557964,119634811,0
1,40,1,4,10,6,45376883,0,53906201,76073006,23399979,153379186,53384566,19538752,72923318,0
1,26,0,4,10,6,62726865,1,10602181,18337599,23399979,52339759,25357668,13773218,39130886,1
1,27,1,2,10,5,30028818,0,28912201,22861940,23399979,75174120,26692283,28203066,54895349,0
1,35,1,1,12,3,6406148,1,32805267,58776409,80076847,171658523,23382441,3074951,26457392,1
1,31,1,4,11,5,30028818,0,28912201,22861940,23399979,75174120,26692283,28203066,54895349,0
1,24,1,4,10,5,30028818,0,28912201,22861940,23399979,75174120,26692283,28203066,54895349,0
1,29,1,3,11,6,13346142,0,40480811,3002081,23399979,66882871,10676913,21300442,31977355,0
1,63,1,2,10,5,51449375,0,55730682,85361923,23399979,164492584,13346142,67264552,80610694,0
1,85,0,0,3,1,30028818,0,28912201,22861940,23399979,75174120,26692283,28203066,54895349,0
1,43,1,4,14,7,3203074,0,71461902,20819981,23399979,115681862,35233815,10233822,45467637,0
0,34,1,6,9,10,54051876,0,18794797,23222287,23399979,65417063,80076849,45163342,125240191,0
1,52,1,6,7,10,18671253,0,1407879,25944901,56053795,83406575,77007241,51008953,128016194,0
1,48,1,0,9,5,30028818,0,28912201,22861940,23399979,75174120,26692283,28203066,54895349,0
1,20,1,6,8,8,30028818,0,28912201,13132603,23399979,65444783,1601537,48846879,50448416,0
1,38,0,1,1,2,64595327,0,82606287,73190239,23399979,179196505,16549217,96092224,112641441,0
1,32,1,2,9,4,77607818,0,10016794,26985898,23399979,60402671,28026898,26905821,54932719,0
1,25,1,3,12,5,30028818,1,28912201,22861940,23399979,75174120,26692283,28203066,54895349,1
1,35,1,2,10,4,52717257,0,28912201,17696983,23399979,70009163,37369194,57975639,95344833,0
1,44,1,6,9,9,56053796,0,35524435,2746636,23399979,61671050,10943837,24343363,35287200,0
1,40,0,5,5,6,23489211,0,12390944,68866089,1601537,82858570,6005764,10570145,16575909,0
0,53,0,2,8,3,13346142,0,28912201,11931451,23399979,64243631,26692283,33632276,60324559,0
1,47,0,8,4,12,28026898,0,44750278,23975009,23399979,92125266,25357668,19378597,44736265,0
1,25,1,2,10,5,30028818,0,28912201,22861940,23399979,75174120,26692283,28203066,54895349,0
1,66,0,1,1,2,84080696,0,28912201,49647648,23399979,101959828,2162075,72069163,74231238,0
1,44,0,4,8,5,30028818,0,28912201,22861940,23399979,75174120,26692283,28203066,54895349,0
1,35,1,4,14,6,30028818,0,89500557,16912231,23399979,129812767,26692283,12251758,38944041,0
1,30,1,5,10,7,18417675,0,7063584,26489423,23399979,56952986,97426834,19218445,116645279,0
1,21,1,2,10,4,1040999,0,28912201,24407423,23399979,76719603,12011528,26505438,38516966,0
1,28,1,4,9,6,20019212,0,28912201,98334373,23399979,150646553,10009606,17616907,27626513,0
1,57,1,1,1,5,65396094,0,82890149,35634198,23399979,141924326,16682677,24023054,40705731,0
1,47,0,1,5,2,9982914,0,68983716,18097368,23399979,110481063,18684598,43401653,62086251,0
1,59,0,1,5,4,18684598,0,26505453,10009606,23399979,59915038,1601537,172966,1774503,0
1,22,1,3,10,5,14680757,0,28912201,13532988,23399979,65845168,53384566,42921192,96305758,0
1,29,1,4,9,6,66730708,0,30635769,74951935,23399979,128987683,53384566,2898782,56283348,0
1,60,0,0,1,5,30028818,0,28912201,22861940,23399979,75174120,26692283,28203066,54895349,0
0,51,0,2,8,5,30028818,1,28912201,22861940,23399979,75174120,26692283,28203066,54895349,1
1,29,1,3,9,5,30028818,0,28912201,22861940,23399979,75174120,26692283,28203066,54895349,0
1,30,1,6,9,8,15348064,0,20206248,15454832,23399979,59061059,21086905,58456101,79543006,0
1,76,0,5,1,7,80076849,0,51428009,14413833,23399979,89241821,10409991,98686707,109096698,0
1,21,1,2,10,5,30028818,0,28912201,22861940,23399979,75174120,26692283,28203066,54895349,0
1,28,1,4,10,5,30028818,0,28912201,22861940,23399979,75174120,26692283,28203066,54895349,0
1,19,1,2,9,5,30028818,0,28912201,22861940,23399979,75174120,26692283,28203066,54895349,0
0,38,1,5,10,5,30028818,0,28912201,22861940,23399979,75174120,26692283,28203066,54895349,0
1,27,1,3,10,5,41639962,0,20651573,1601537,23399979,45653089,16682677,10602175,27284852,0
1,26,1,1,8,3,21353827,0,12390944,1753683,23399979,37544606,18497753,57495178,75992931,0
1,40,0,1,9,2,28827665,0,24164206,22645734,16015369,62825309,11210759,22261364,33472123,0
1,23,1,2,9,5,30028818,0,28912201,22861940,23399979,75174120,26692283,28203066,54895349,0
1,26,1,2,13,4,24023056,1,36350497,32751431,32030739,101132667,21433905,26841761,48275666,1
1,27,1,3,13,5,30028818,1,28912201,22861940,23399979,75174120,26692283,28203066,54895349,1
1,26,1,2,6,4,80076847,0,21617699,17376677,23399979,62394355,25624592,49487492,75112084,0
1,35,0,0,9,1,33365354,0,78475975,27114023,16015369,121605367,33365355,12652143,46017498,0
1,51,1,4,10,5,30028818,0,28912201,22861940,23399979,75174120,26692283,28203066,54895349,0
1,20,1,2,9,4,53384566,0,12390944,53651489,23399979,89442412,26692283,24023056,50715339,0
1,72,0,5,5,9,24023054,0,20651573,22085196,23399979,66136748,70067245,94490681,164557926,0
1,23,1,2,9,4,10676913,0,37172832,32655341,24023054,93851227,17349985,46925034,64275019,0
1,33,0,3,12,4,98761454,0,41303146,24743747,23399979,89446872,1508114,19298521,20806635,0
1,28,1,2,8,4,16015369,0,12390944,25896854,23399979,61687777,80076847,8664315,88741162,0
1,49,1,4,11,8,21687479,0,20651573,57815485,96092224,174559282,18684598,16655985,35340583,0
1,59,1,6,12,8,8701684,0,5184104,26905823,23399979,55489906,28961128,21220366,50181494,0
1,20,1,3,10,5,22421518,0,19851755,21812933,23399979,65064667,26692283,32671356,59363639,0
1,40,1,5,9,5,30028818,0,28912201,22861940,23399979,75174120,26692283,28203066,54895349,0
1,31,1,4,9,6,95024529,0,16521257,16095447,23399979,56016683,40038424,41880192,81918616,0
1,38,0,3,10,5,30028818,0,28912201,22861940,23399979,75174120,26692283,28203066,54895349,0
1,32,0,3,14,5,3203074,0,86736603,21220366,11210759,119167728,33365355,24775778,58141133,0
1,40,0,6,10,8,80076847,0,86736603,17264569,23399979,127401151,66730709,89205612,155936321,0
1,47,1,4,6,5,30028818,0,28912201,22861940,23399979,75174120,26692283,28203066,54895349,0
0,65,0,1,10,3,10676913,0,35524435,21941057,3203074,60668566,26692283,48046112,74738395,0
1,31,1,4,14,5,30028818,0,28912201,22861940,23399979,75174120,26692283,28203066,54895349,0
1,47,1,4,1,5,30028818,0,28912201,22861940,23399979,75174120,26692283,28203066,54895349,0
1,25,1,2,10,4,28026897,0,17142671,17072385,23399979,57615035,40038425,32030739,72069164,0
1,22,1,4,8,6,24356709,0,5714122,29628435,23399979,58742536,72069162,19378597,91447759,0
1,27,1,4,9,5,30028818,1,28912201,22861940,23399979,75174120,26692283,28203066,54895349,1
1,53,1,0,4,3,82479153,0,83646683,26105054,23399979,133151716,24023056,18417675,42440731,0
1,26,1,3,10,5,20553058,0,34285342,33872507,23399979,91557828,44309193,24823824,69133017,0
1,32,1,4,12,6,33365355,0,5714122,16207555,23399979,45321656,66063399,36194736,102258135,0
1,18,1,3,9,4,54719181,0,37172832,80557312,23399979,141130123,26692283,20819981,47512264,0
0,64,0,0,7,5,30028818,0,28912201,22861940,23399979,75174120,26692283,28203066,54895349,0
1,28,0,4,10,5,30028818,0,28912201,22861940,23399979,75174120,26692283,28203066,54895349,0
1,54,1,0,7,2,42707653,0,17968733,18433691,23399979,59802403,56053796,14413833,70467629,0
1,56,0,0,4,1,30028818,1,28912201,1040999,23399979,53353179,69399939,26137083,95537022,1
1,37,1,5,10,7,93422985,1,6712542,14894295,80076847,101683684,13346142,67264557,80610699,1
1,22,1,3,10,5,30028818,0,28912201,22861940,23399979,75174120,26692283,28203066,54895349,0
1,28,1,3,9,5,40038424,0,388964,14782187,48046112,63217263,13613064,23702747,37315811,0
1,35,1,1,8,5,81411467,0,71461603,35313892,23399979,130175474,46711493,22357456,69068949,0
0,43,1,2,10,6,20286135,1,82606293,10563738,1601537,94771568,41373043,34913507,76286550,1
1,27,1,2,10,4,98761454,0,41303144,15887247,23399979,80590370,12011527,14093526,26105053,0
1,62,1,0,8,2,24023056,0,18381764,56053795,23399979,97835538,26692283,92889147,119581430,0
1,70,1,3,6,7,30028818,1,36763528,13132603,23399979,73296110,17349985,59256868,76606853,1
1,32,1,5,9,8,93422991,0,12390944,12491988,23399979,48282911,93422994,68465706,161888700,0
1,38,1,0,7,2,30028818,0,38002625,325112,1601537,39929274,46711496,26745668,73457164,0
1,22,1,4,8,6,30028818,0,82606287,14894295,23399979,120900561,15481524,78315158,93796682,0
1,25,1,3,9,5,36034582,0,19620555,16191539,23399979,59212073,31363432,12411912,43775344,0
1,29,1,6,8,5,30028818,1,28912201,22861940,23399979,75174120,26692283,28203066,54895349,1
1,49,0,1,6,5,30028818,0,28912201,22861940,23399979,75174120,26692283,28203066,54895349,0
1,44,1,5,6,9,30028818,0,18381764,16335678,23399979,58117421,10676913,13613065,24289978,0
1,51,1,4,9,5,30028818,0,28912201,22861940,23399979,75174120,26692283,28203066,54895349,0
1,40,1,0,8,3,48046112,0,42890683,46684802,23399979,112975464,53384566,12549644,65934210,0
1,31,1,1,10,3,36034582,0,77792801,27130035,23399979,128322815,40038424,14573987,54612411,0
1,39,1,8,10,10,53384566,0,20651573,20707874,96092224,137451671,1414691,26905821,28320512,0
1,45,1,4,9,6,12411911,0,82606287,1470211,23399979,107476477,76073008,12011527,88084535,0
0,73,0,3,10,5,30028818,1,28912201,22861940,23399979,75174120,26692283,28203066,54895349,1
1,21,0,3,10,5,30028818,0,28912201,22861940,23399979,75174120,26692283,28203066,54895349,0
1,42,1,3,9,5,30028818,0,28912201,22861940,23399979,75174120,26692283,28203066,54895349,0
1,33,1,2,7,4,51249185,0,28912201,18914153,23399979,71226333,34699969,20611782,55311751,0
1,27,1,4,10,6,22021133,1,28912201,21755278,80076851,130744330,30696125,40358734,71054859,1
1,25,1,0,10,2,23355746,0,30635769,10890452,23399979,64926200,22688441,22741825,45430266,0
1,38,1,3,14,5,43775349,0,6474906,12091605,23399979,41966490,14814217,12732219,27546436,0
1,21,1,5,10,7,30028818,0,28912201,34433044,23399979,86745224,25624592,19138367,44762959,0
1,45,1,7,8,10,64061481,0,5954797,19698904,23399979,49053680,11744605,33632278,45376883,0
1,33,0,6,10,7,12011528,0,28912201,18898137,80076849,127887187,70734549,1040999,71775548,0
1,35,1,4,9,5,30028818,0,28912201,22861940,23399979,75174120,26692283,28203066,54895349,0
1,24,1,3,11,5,3203074,0,41303144,15294678,23399979,79997801,40038424,18417675,58456099,0
1,26,1,2,8,3,3203074,0,28912201,18017291,22421518,69351010,26158438,71909012,98067450,0
1,23,0,2,10,3,21887674,0,28912201,97693756,23399979,150005936,73403783,99295292,172699075,0
1,21,1,2,9,5,30028818,0,28912201,22861940,23399979,75174120,26692283,28203066,54895349,0
1,34,1,1,14,5,30028818,0,28912201,22861940,23399979,75174120,26692283,28203066,54895349,0
1,23,1,2,10,3,36034582,0,28912201,10970528,23399979,63282708,38169963,41800117,79970080,0
1,26,0,3,5,4,81411467,0,20651573,15855217,23399979,59906769,10676913,88084536,98761449,0
1,36,1,4,8,6,66730709,0,72700995,23462517,80076847,176240359,62459941,89686069,152146010,0
1,20,1,3,10,5,30028818,0,28912201,22861940,23399979,75174120,26692283,28203066,54895349,0
1,23,1,3,10,5,13679795,0,83646683,22741826,2162075,108550584,60591483,55413181,116004664,0
1,32,1,3,9,5,37369196,1,1886281,22245349,96092224,120223854,26692283,26905821,53598104,1
1,44,0,1,9,5,30028818,0,28912201,22861940,23399979,75174120,26692283,28203066,54895349,0
1,25,1,3,14,5,30028818,0,37172832,29868665,23399979,90441476,1414691,2162075,3576766,0
1,43,1,4,10,6,96759529,0,82606287,38997427,23399979,145003693,20019212,36194736,56213948,0
0,60,0,0,6,1,40038425,0,28912201,26825745,23222287,78960233,26692283,3203074,29895357,0
1,26,1,2,9,4,12465296,0,14251147,28010883,12812296,55074326,22648401,28507359,51155760,0
1,20,1,1,7,3,36034581,0,20651573,20499673,24023056,65174302,17616907,25720684,43337591,0
1,27,1,3,10,5,46711493,0,82606287,17616907,23399979,123623173,46711493,35458031,82169524,0
1,20,1,1,11,3,31763819,0,24612654,41671994,24023054,90307702,86483002,28026897,114509899,0
1,29,0,0,10,1,11210759,0,87776993,18737982,23399979,129914954,89419144,21300442,110719586,0
1,23,1,1,10,3,25090746,0,22375139,23782825,23399979,69557943,60724945,22869947,83594892,0
1,27,1,6,7,5,30028818,1,28912201,22861940,23399979,75174120,26692283,28203066,54895349,1
1,30,1,2,9,4,45376883,0,53010906,20019212,19218445,92248563,33365355,34673275,68038630,0
1,56,1,7,14,5,30028818,0,28912201,22861940,23399979,75174120,26692283,28203066,54895349,0
1,25,0,3,9,5,30028818,1,28912201,22861940,23399979,75174120,26692283,28203066,54895349,1
1,33,1,4,10,6,78742232,0,82606287,10730298,23399979,116736564,46711493,38116581,84828074,0
1,26,1,3,9,5,30028818,0,28912201,22861940,23399979,75174120,26692283,28203066,54895349,0
0,24,1,1,17,5,30028818,0,28912201,22861940,23399979,75174120,26692283,28203066,54895349,0
1,32,1,4,12,6,1040999,0,82606287,52049953,80076847,214733087,57388411,17520815,74909226,0
1,35,1,6,9,9,96092224,1,66401184,15374756,32030739,113806679,66730708,25464437,92195145,1
1,39,1,7,12,12,74738393,1,16521257,33231894,3203074,52956225,27359591,95739883,123099474,1
1,46,1,2,7,5,66730709,0,47951096,94170372,23399979,165521447,33365355,83279924,116645279,0
1,26,1,5,9,7,22955363,0,28912201,20259444,23399979,72571624,25891516,15374755,41266271,0
1,54,1,0,8,5,30028818,0,28912201,22861940,23399979,75174120,26692283,28203066,54895349,0
1,33,1,3,10,5,53384566,1,61272449,22982056,23399979,107654484,14680755,52930798,67611553,1
1,24,1,3,11,5,19485367,0,16521257,32190894,64061478,112773629,16015369,10089683,26105052,0
1,23,1,4,8,6,6406148,1,30635769,55253025,23399979,109288773,72069162,18257523,90326685,1
1,24,1,3,10,5,30028818,0,28912201,22861940,23399979,75174120,26692283,28203066,54895349,0
1,28,1,4,10,6,10676913,0,41410913,17128438,23399979,81939330,26692283,10249837,36942120,0
1,29,1,3,7,5,30028818,0,41303144,28026898,23399979,92730021,51382647,33632278,85014925,0
1,26,0,4,10,6,26692283,0,28912201,20515689,6406148,55834038,50715337,15855216,66570553,0
1,25,1,2,9,4,30429204,0,45433456,25832791,28827665,100093912,17750368,47501587,65251955,0
1,40,1,7,9,9,18684598,0,86053429,12011527,23399979,121464935,40038424,28219082,68257506,0
1,42,1,4,12,6,18684597,0,11187569,17761046,23399979,52348594,30696127,89686069,120382196,0
1,76,1,0,10,2,10276529,0,41303144,32831509,23399979,97534632,26692283,12812296,39504579,0
1,26,1,3,7,5,26692283,0,65401855,15614986,88084534,169101375,5939033,22261364,28200397,0
1,20,1,1,10,3,53384566,0,97761192,17696983,23399979,138858154,96092218,14413833,110506051,0
1,26,1,3,10,5,30028818,0,28912201,22861940,23399979,75174120,26692283,28203066,54895349,0
1,19,1,2,12,5,30028818,0,28912201,22861940,23399979,75174120,26692283,28203066,54895349,0
1,20,1,2,10,5,30028818,0,28912201,22861940,23399979,75174120,26692283,28203066,54895349,0
1,25,1,3,10,5,22288055,0,40997882,10810374,23399979,75208235,56053796,12331835,68385631,0
1,22,1,1,10,3,28026898,0,28912201,1297245,23399979,53609425,66730709,28347204,95077913,0
1,29,1,2,11,4,36034582,0,82606287,10890452,23399979,116896718,40038424,31181925,71220349,0
1,81,0,0,1,5,30028818,1,28912201,22861940,23399979,75174120,26692283,28203066,54895349,1
1,54,1,7,9,9,12612103,1,12178716,257367,19218445,31654528,3203074,28203066,31406140,1
1,39,0,1,6,3,61392255,0,24781887,21700827,24023054,70505768,2669229,16816139,19485368,0
1,27,1,3,14,5,53384566,1,16316304,75752698,97693756,189762758,10009606,90486839,100496445,1
1,24,1,2,10,4,10676913,0,19620555,21989104,23399979,65009638,24023056,11675204,35698260,0
1,37,1,5,9,7,60057635,0,35007062,19298521,3203074,57508657,54185338,33440094,87625432,0
1,46,1,3,8,5,10943837,0,10429825,43113376,32030739,85573940,1975229,22485579,24460808,0
1,22,1,1,10,5,30028818,0,28912201,22861940,23399979,75174120,26692283,28203066,54895349,0
1,25,1,2,10,4,1601537,0,49563774,17216522,23399979,90180275,13346142,12732219,26078361,0
1,19,1,2,8,5,30028818,0,28912201,22861940,23399979,75174120,26692283,28203066,54895349,0
1,35,0,3,10,5,52049952,0,52667108,23542593,17937214,94146915,1601537,80076847,81678384,0
1,39,1,5,9,5,30028818,0,28912201,22861940,23399979,75174120,26692283,28203066,54895349,0
1,49,1,1,6,5,30028818,0,28912201,22861940,23399979,75174120,26692283,28203066,54895349,0
1,42,1,5,9,9,53384566,0,28912201,18737982,23399979,71050162,1601537,36034582,37636119,0
1,28,1,3,5,5,54719181,0,54078564,46844958,23399979,124323501,58723021,23542593,82265614,0
1,33,1,3,10,5,3203074,0,25162625,10922482,3843689,39928796,28026898,29147974,57174872,0
1,26,1,3,9,5,33365355,0,45433456,27626514,23399979,96459949,36034582,39285702,75320284,0
1,39,1,4,9,6,26692283,0,41303146,1040999,23399979,65744124,26692283,31069818,57762101,0
1,22,1,3,10,6,14680755,0,89500557,12331835,23399979,125232371,62459946,33472122,95932068,0
1,20,1,2,9,4,16415755,0,82606287,13885326,23399979,119891592,65396094,92889147,158285241,0
1,28,1,2,5,5,30028818,1,28912201,22861940,23399979,75174120,26692283,28203066,54895349,1
1,26,1,7,8,5,30028818,0,28912201,22861940,23399979,75174120,26692283,28203066,54895349,0
1,27,1,2,10,4,25090746,0,19207828,21156303,80076847,120440978,16015369,25336315,41351684,0
1,33,1,2,10,4,10276529,1,28912201,14814217,3203074,46929492,19351906,12892373,32244279,1
1,21,1,2,10,4,45376883,0,53010906,9689299,23399979,86100184,21353827,3074951,24428778,0
1,35,1,7,10,9,22421517,0,12390944,70467628,23399979,106258551,66730708,56694408,123425116,0
1,47,1,2,5,4,13346142,1,82606287,18337599,23399979,124343865,36701891,2162075,38863966,1
1,53,1,7,9,10,16015369,0,15077211,162556,23399979,38639746,6005764,15214602,21220366,0
1,36,1,3,10,5,23489211,0,24781887,23302364,23399979,71484230,32964969,19698906,52663875,0
1,40,0,2,10,3,20019213,0,43026714,13773218,23399979,80199911,23008747,58936562,81945309,0
1,56,0,2,8,5,46711493,0,17968733,1383728,23399979,42752440,26291898,1705637,27997535,0
1,27,1,4,9,5,30028818,0,28912201,22861940,23399979,75174120,26692283,28203066,54895349,0
1,22,1,2,3,4,48046112,0,41303144,72869934,23399979,137573057,24023056,80076847,104099903,0
1,32,0,4,10,5,19044944,0,53010906,49167187,23399979,125578072,12678834,16816139,29494973,0
1,86,0,0,1,1,30028818,0,82606287,11531066,23399979,117537332,36034581,44843035,80877616,0
1,57,0,4,6,6,30028818,0,82606287,25624592,23399979,131630858,42707652,18577829,61285481,0
1,27,1,3,10,5,30028818,0,28912201,22861940,23399979,75174120,26692283,28203066,54895349,0
1,19,1,1,10,5,30028818,0,28912201,22861940,23399979,75174120,26692283,28203066,54895349,0
1,68,1,0,1,5,30028818,0,28912201,22861940,23399979,75174120,26692283,28203066,54895349,0
1,28,1,3,7,5,53384566,0,37172832,1937059,23399979,62509870,46711496,411595,47123091,0
1,52,1,4,3,5,30028818,0,28912201,22861940,23399979,75174120,26692283,28203066,54895349,0
0,21,1,2,10,4,18684598,0,28912201,39237656,23399979,91549836,20019212,43241501,63260713,0
1,26,0,1,8,5,30028818,0,28912201,22861940,23399979,75174120,26692283,28203066,54895349,0
0,45,0,1,7,2,30028818,0,28912201,32351048,6406148,67669397,18417675,15534909,33952584,0
1,30,1,2,10,5,30028818,0,28912201,22861940,23399979,75174120,26692283,28203066,54895349,0
0,26,0,1,10,5,30028818,0,28912201,22861940,23399979,75174120,26692283,28203066,54895349,0
1,51,1,1,3,4,26024977,0,47021002,31646371,23399979,102067352,13679795,28379236,42059031,0
1,25,1,3,8,5,80076847,0,22485095,24423439,23399979,70308513,12278451,19218445,31496896,0
1,23,0,5,9,6,30028818,0,33042515,17584877,12812296,63439688,74071088,25544516,99615604,0
1,29,1,4,9,6,37369196,0,13493401,21220366,14413833,49127600,37369198,25144131,62513329,0
1,91,0,0,8,5,30028818,0,28912201,22861940,23399979,75174120,26692283,28203066,54895349,0
1,32,0,3,10,4,30028818,0,41303146,12812296,80076847,134192289,29895358,31374109,61269467,0
1,66,0,0,1,5,30028818,0,28912201,22861940,23399979,75174120,26692283,28203066,54895349,0
1,47,1,1,7,7,19578791,0,35524435,14894295,23399979,73818709,13746526,17937214,31683740,0
1,25,1,4,12,6,6406148,1,39654752,91287605,23399979,154342336,84080696,17969246,102049942,1
1,27,1,3,9,5,30028818,1,28912201,22861940,23399979,75174120,26692283,28203066,54895349,1
1,21,1,1,10,5,30028818,0,28912201,22861940,23399979,75174120,26692283,28203066,54895349,0
1,72,0,0,5,1,30028818,0,28912201,80076847,23399979,132389027,26692283,28203066,54895349,0
1,25,1,0,10,2,46711493,0,89500557,30429203,23399979,143329739,25357668,99455452,124813120,0
1,18,0,0,9,5,30028818,1,28912201,22861940,23399979,75174120,26692283,28203066,54895349,1
1,39,1,6,8,8,71762204,1,24781887,12251758,80076849,117110494,26692283,24423439,51115722,1
1,19,1,2,1,5,30028818,0,28912201,22861940,23399979,75174120,26692283,28203066,54895349,0
1,20,1,3,7,5,30028818,0,28912201,22861940,23399979,75174120,26692283,28203066,54895349,0
1,34,1,5,11,7,11210759,0,38415656,24263286,23399979,86078921,68065324,22581671,90646995,0
1,36,1,5,8,7,73403783,0,26161044,10490067,23399979,60051090,11344221,28203066,39547287,0
1,22,1,2,10,4,10143067,0,49563774,23062132,19218445,91844351,10145737,31069818,41215555,0
1,19,1,1,10,5,30028818,0,28912201,22861940,23399979,75174120,26692283,28203066,54895349,0
1,80,0,2,1,4,1227845,1,28912201,60858407,23399979,113170587,2535767,26905823,29441590,1
0,36,1,4,10,5,30028818,1,28912201,22861940,23399979,75174120,26692283,28203066,54895349,1
1,28,1,4,8,6,30028818,0,37172832,21458994,19218445,77850271,29308126,31710432,61018558,0
1,25,1,3,13,5,30028818,0,28912201,22861940,23399979,75174120,26692283,28203066,54895349,0
1,51,0,0,9,1,30028818,0,14043069,47245342,23399979,84688390,81411463,14573987,95985450,0
1,59,0,0,7,5,30028818,0,28912201,22861940,23399979,75174120,26692283,28203066,54895349,0
1,29,1,5,10,5,30028818,0,28912201,22861940,23399979,75174120,26692283,28203066,54895349,0
1,32,1,4,9,6,14680755,0,64680737,13484941,23399979,101565657,12732219,25688654,38420873,0
1,53,0,3,1,5,30028818,1,28912201,22861940,23399979,75174120,26692283,28203066,54895349,1
1,30,1,1,9,3,2936151,0,81923103,10409991,23399979,115733073,21353827,41639962,62993789,0
1,24,1,3,10,5,30028818,0,28912201,22861940,23399979,75174120,26692283,28203066,54895349,0
1,69,0,0,1,5,30028818,1,28912201,22861940,23399979,75174120,26692283,28203066,54895349,1
1,38,0,2,8,4,28026898,0,82606287,36034584,23399979,142040850,64061481,12604096,76665577,0
1,19,1,2,8,5,30028818,0,28912201,22861940,23399979,75174120,26692283,28203066,54895349,0
0,58,1,3,8,5,1601537,0,6712542,16736061,23399979,46848582,26692283,73670702,100362985,0
1,47,1,4,9,6,12011527,0,41651593,24103131,23399979,89154703,10676913,15695063,26371976,0
1,21,1,3,3,5,13346142,1,28912201,42921192,23399979,95233372,66730708,15454832,82185540,1
1,22,0,3,12,5,30028818,0,28912201,22861940,23399979,75174120,26692283,28203066,54895349,0
1,36,1,3,10,5,30028818,1,28912201,22861940,23399979,75174120,26692283,28203066,54895349,1
1,35,1,8,8,5,30028818,0,28912201,22861940,23399979,75174120,26692283,28203066,54895349,0
1,25,1,7,7,9,80076847,0,28912201,15534909,23399979,67847089,49380727,13436895,62817622,0
1,42,1,4,8,5,30028818,0,28912201,22861940,23399979,75174120,26692283,28203066,54895349,0
1,22,1,2,11,4,38703811,0,62374603,29308127,1601537,93284267,73403783,5475655,78879438,0
1,26,1,4,8,5,30028818,0,28912201,22861940,23399979,75174120,26692283,28203066,54895349,0
1,22,1,1,16,3,30028818,0,12322626,19394614,88084536,119801776,2936151,88084536,91020687,0
1,29,1,2,10,4,12185027,1,47469446,28347205,20819981,96636632,10676913,20019213,30696126,1
1,41,0,0,11,1,10409991,0,18192484,14125557,23399979,55718020,20019212,4724534,24743746,0
1,20,1,3,10,5,37369196,0,46367291,75912857,48046112,170326260,11891412,31566294,43457706,0
1,67,1,4,10,6,27759974,0,33042515,1016976,16015369,50074860,13346142,72069163,85415305,0
1,31,1,3,10,5,30028818,0,28912201,22861940,23399979,75174120,26692283,28203066,54895349,0
1,68,0,0,1,2,26692283,0,37176559,11851374,12812296,61840229,33365355,4103138,37468493,0
1,25,1,3,10,5,80076849,1,33042515,19218443,23399979,75660937,24023056,12011527,36034583,1
1,22,1,2,10,5,30028818,1,28912201,22861940,23399979,75174120,26692283,28203066,54895349,1
1,24,1,2,8,4,15348064,1,44750278,23462517,23399979,91612774,19391944,30829588,50221532,1
1,32,1,5,10,7,17603559,0,13920652,11771297,23399979,49091928,42707653,23542593,66250246,0
1,32,1,4,10,6,30028818,0,53010906,2684176,23399979,79095061,72736468,60858406,133594874,0
1,58,1,0,3,4,30028818,0,37761951,29163989,23399979,90325919,96092218,59256868,155349086,0
1,23,1,3,10,5,30028818,0,28912201,22861940,23399979,75174120,26692283,28203066,54895349,0
1,24,1,3,10,5,30028818,0,28912201,22861940,23399979,75174120,26692283,28203066,54895349,0
1,48,1,5,7,5,30028818,0,28912201,22861940,23399979,75174120,26692283,28203066,54895349,0
1,35,1,6,12,8,66730708,0,41303144,48846878,23399979,113550001,21727518,87283764,109011282,0
1,78,0,0,1,5,30028818,1,28912201,22861940,23399979,75174120,26692283,28203066,54895349,1
1,29,1,2,9,4,72069163,0,50773999,25864822,23399979,100038800,12545373,93369606,105914979,0
1,23,1,4,9,6,26692283,0,28912201,16736061,23399979,69048241,13346142,33952583,47298725,0
1,26,1,4,8,6,28827665,0,33042515,10249837,23399979,66692331,53384566,16015369,69399935,0
1,29,1,2,8,4,74738393,1,10602181,68225479,40038424,118866084,53384566,70467628,123852194,1
1,34,1,2,10,4,30696127,0,24781887,48526572,23399979,96708438,12011528,10570145,22581673,0
0,21,1,0,10,2,45376883,0,28912201,16095447,10089683,55097331,93422991,40679039,134102030,0
1,29,1,1,9,3,48046112,0,20651573,11851374,23399979,55902926,17349985,14253679,31603664,0
1,35,1,6,10,8,33365355,0,44750278,27017929,23399979,95168186,37369196,54532333,91901529,0
1,24,1,3,9,5,30028818,0,28912201,22861940,23399979,75174120,26692283,28203066,54895349,0
1,35,1,4,10,6,14947679,0,21858374,29067896,23399979,74326249,1601537,15214602,16816139,0
0,35,1,0,7,2,19351906,0,44750278,99455444,23399979,167605701,93422985,34673275,128096260,0
1,32,1,4,10,6,15348063,0,82606287,17136446,1601537,101344270,28026897,11851374,39878271,0
1,40,1,3,19,5,85415306,0,52254071,14654063,23399979,90308113,26692283,23702747,50395030,0
1,20,1,1,8,3,66730709,0,28912201,23222287,23399979,75534467,2936151,23222286,26158437,0
1,54,0,0,9,1,12011528,0,72700995,22261365,23399979,118362339,26692283,42440729,69133012,0
1,31,1,5,9,7,71535316,0,41303146,1321268,23399979,66024393,54051876,60698254,114750130,0
0,63,0,0,8,5,30028818,0,28912201,22861940,23399979,75174120,26692283,28203066,54895349,0
1,27,1,3,14,5,90753765,0,34285342,32831509,32030739,99147590,60057635,66944244,127001879,0
1,36,0,4,10,6,86082611,0,16521257,23862901,23399979,63784137,26692283,48062126,74754409,0
0,52,0,2,9,4,61926098,1,28912201,53571411,23399979,105883591,33365355,23222286,56587641,1
1,19,1,1,10,5,30028818,0,28912201,22861940,23399979,75174120,26692283,28203066,54895349,0
1,23,1,3,9,5,59256868,1,28912201,13452911,23399979,65765091,93422991,34433044,127856035,1
1,31,0,2,10,3,35233815,0,57824402,11851374,48046112,117721888,12144989,27786667,39931656,0
0,20,1,1,9,5,30028818,0,28912201,22861940,23399979,75174120,26692283,28203066,54895349,0
1,27,1,2,8,4,94757605,0,15386201,99135139,16015369,130536709,24556902,29468281,54025183,0
1,29,0,9,8,5,30028818,1,28912201,22861940,23399979,75174120,26692283,28203066,54895349,1
1,36,1,5,9,7,1601537,1,20651573,22197302,12011527,54860402,22021134,44522728,66543862,1
1,34,1,4,14,7,30028818,0,98444366,16688016,80076847,195209229,26692283,34433044,61125327,0
1,22,1,2,9,4,26692283,1,41303146,72069168,48046108,161418422,14680755,95131302,109812057,1
1,28,1,7,10,9,42707653,1,28912201,34272891,96092224,159277316,39371116,43401653,82772769,1
1,22,1,1,1,3,21353827,0,6712542,36194736,23399979,66307257,15881909,67264557,83146466,0
1,30,1,6,10,8,66730709,0,28912201,51489417,80076847,160478465,28694205,49167187,77861392,0
1,23,1,0,9,2,30028818,0,2251208,13933372,23399979,39584559,17349985,14253679,31603664,0
1,17,1,4,9,5,30028818,0,28912201,22861940,23399979,75174120,26692283,28203066,54895349,0
1,25,1,4,10,5,30028818,0,28912201,22861940,23399979,75174120,26692283,28203066,54895349,0
1,23,1,1,10,3,30028818,0,28912201,15214601,23399979,67526781,29361513,52690567,82052080,0
1,24,1,3,10,5,16682676,0,28912201,83279922,16015369,128207492,37903044,24343363,62246407,0
1,23,1,4,9,6,20286135,0,45541229,12011527,23399979,80952735,13346142,16143494,29489636,0
1,33,0,4,10,5,15681717,0,10285602,14814217,60858406,85958225,29601741,1643177,31244918,0
1,30,0,3,13,5,30028818,0,28912201,22861940,23399979,75174120,26692283,28203066,54895349,0
1,25,0,3,10,4,30028818,0,28912201,14013449,23399979,66325629,26692283,24263285,50955568,0
1,32,1,4,8,6,67758365,0,41303144,76873779,23399979,141576902,40038425,15374755,55413180,0
1,43,1,6,6,9,18017291,0,28912201,32671356,23399979,84983536,66730708,22693779,89424487,0
1,42,1,2,9,4,60858407,0,53080133,28587436,28827665,110495234,74738393,51889797,126628190,0
1,37,1,6,10,9,17083061,0,37172832,23510564,35233814,95917210,40038425,60698254,100736679,0
1,41,0,3,14,4,19585463,0,42650009,34593201,23399979,100643189,13879987,11595128,25475115,0
1,31,0,5,10,5,30028818,0,28912201,22861940,23399979,75174120,26692283,28203066,54895349,0
1,55,0,4,6,5,30028818,0,28912201,22861940,23399979,75174120,26692283,28203066,54895349,0
1,61,1,0,4,2,11878066,0,20619279,66463783,23399979,110483041,13346141,30429204,43775345,0
1,47,1,2,1,5,43775349,1,27545317,31950662,59256868,118752847,20419598,18737984,39157582,1
1,21,1,2,10,3,40038424,0,2833024,29436249,23399979,55669252,65396094,10570145,75966239,0
1,34,0,1,9,3,93422985,0,41303144,38885318,23399979,103588441,31363434,14894294,46257728,0
0,20,1,1,9,5,30028818,0,28912201,22861940,23399979,75174120,26692283,28203066,54895349,0
0,42,0,1,10,5,30028818,0,28912201,22861940,23399979,75174120,26692283,28203066,54895349,0
1,31,1,2,9,5,30028818,1,28912201,22861940,23399979,75174120,26692283,28203066,54895349,1
1,26,1,2,9,4,30429204,0,53694088,13532988,3203074,70430150,46711493,17696983,64408476,0
0,23,1,1,10,2,93422991,0,23269824,19859059,23399979,66528862,26692283,72069163,98761446,0
1,25,1,4,9,5,30028818,0,28912201,22861940,23399979,75174120,26692283,28203066,54895349,0
1,47,1,0,5,5,30028818,0,28912201,22861940,23399979,75174120,26692283,28203066,54895349,0
1,41,0,3,10,4,20553058,0,37172832,99295296,23399979,159868107,53384566,25464439,78849005,0
1,58,1,0,9,5,30028818,1,28912201,22861940,23399979,75174120,26692283,28203066,54895349,1
1,23,1,1,10,3,17083061,0,82606287,12732219,23399979,118738485,27493052,37796272,65289324,0
1,20,1,4,10,6,56053796,0,20651573,21540672,19218445,61410690,37369196,61659176,99028372,0
1,19,1,2,9,5,30028818,0,28912201,22861940,23399979,75174120,26692283,28203066,54895349,0
1,22,1,0,10,2,53384566,1,28912201,16015369,23399979,68327549,53384566,65663018,119047584,1
1,35,1,2,12,4,90753765,0,388964,21620749,23399979,45409692,29228051,26249191,55477242,0
1,36,1,3,8,6,20019212,0,83646683,20243428,6406148,110296259,40038424,14573987,54612411,0
1,36,1,7,14,5,30028818,1,28912201,22861940,23399979,75174120,26692283,28203066,54895349,1
1,32,1,2,9,4,21353827,0,24781887,21540672,23399979,69722538,42707653,44042267,86749920,0
1,43,1,3,10,5,50715337,1,20651573,19298521,23399979,63350073,60057635,68866091,128923726,1
1,44,1,5,8,7,10676913,0,28912201,26905823,80076847,135894871,70734549,76553467,147288016,0
1,49,1,4,8,7,53384566,0,59792676,19378598,23399979,102571253,26692283,2234144,28926427,0
1,34,1,3,10,5,20019212,0,28912201,78475311,23399979,130787491,13479604,62459941,75939545,0
1,34,0,3,1,5,74738393,0,86053429,736707,23399979,110190115,14680755,89686069,104366824,0
1,36,1,4,14,6,1601537,0,20651573,17136446,23399979,61187998,2175421,14109541,16284962,0
1,37,0,2,9,5,30028818,0,28912201,22861940,23399979,75174120,26692283,28203066,54895349,0
1,57,1,4,1,7,40038424,0,83646683,11370913,23399979,118417575,26692283,58936562,85628845,0
1,61,0,0,1,5,30028818,1,28912201,22861940,23399979,75174120,26692283,28203066,54895349,1
1,29,1,4,9,5,30028818,0,28912201,22861940,23399979,75174120,26692283,28203066,54895349,0
1,58,1,3,9,5,30028818,0,28912201,22861940,23399979,75174120,26692283,28203066,54895349,0
1,45,1,3,9,6,26692283,0,17142671,35249829,23399979,75792479,19618828,55733486,75352314,0
1,31,1,4,9,6,48046112,0,42236978,19859059,23399979,85496016,70734549,14253679,84988228,0
1,23,1,3,10,5,50715337,0,20651573,16655984,16015369,53322926,40038424,10329914,50368338,0
1,36,1,4,10,7,42040348,0,39654752,2794682,23399979,65849413,47512264,64413818,111926082,0
1,35,1,3,10,6,80076847,0,40825528,30669434,23399979,94894941,2268844,14413833,16682677,0
1,21,1,2,8,5,30028818,0,28912201,22861940,23399979,75174120,26692283,28203066,54895349,0
1,23,1,5,6,5,30028818,0,28912201,22861940,23399979,75174120,26692283,28203066,54895349,0
1,48,1,8,8,5,30028818,0,28912201,22861940,23399979,75174120,26692283,28203066,54895349,0
1,35,1,5,14,7,85415306,0,76069229,40198578,23399979,139667786,50715337,72069163,122784500,0
1,19,0,0,1,2,73937621,0,33042515,35233814,23399979,91676308,26692283,23222287,49914570,0
1,73,0,0,1,2,13346142,1,3876037,54452259,23399979,81728275,20819981,68065324,88885305,1
1,36,1,2,7,4,30028818,0,24781887,20419597,17616907,62818391,46711496,22101212,68812708,0
1,40,1,3,4,5,30028818,0,28912201,22861940,23399979,75174120,26692283,28203066,54895349,0
1,19,1,2,11,4,80076847,0,18553818,28106973,25624591,72285382,38703811,46124264,84828075,0
1,37,0,2,7,5,30028818,0,28912201,22861940,23399979,75174120,26692283,28203066,54895349,0
1,18,1,3,9,4,3203074,0,20651573,66463783,48046108,135161464,6406148,3074951,9481099,0
1,37,1,5,10,7,10143067,0,25094307,18577829,23399979,67072115,91020679,17456753,108477432,0
1,21,1,3,5,5,18684598,1,18381764,13324788,23399979,55106531,44042268,54452257,98494525,1
1,37,0,4,9,5,30028818,0,16729337,13693141,48046112,78468590,13012488,18779623,31792111,0
1,22,0,3,8,7,93422991,1,20651573,1992312,96092224,118736109,36034582,26265207,62299789,1
1,26,1,2,11,4,17750368,0,94314049,38148611,23399979,155862639,23489211,18337599,41826810,0
1,35,1,3,10,5,15815178,0,10325787,53411261,32030739,95767787,46711493,34192814,80904307,0
0,25,0,0,8,5,30028818,0,28912201,22861940,23399979,75174120,26692283,28203066,54895349,0
0,51,0,2,14,3,58723021,0,75386055,11851374,76873775,164111204,26692283,22421518,49113801,0
1,49,1,0,14,3,80076847,0,35524435,38901334,23399979,97825748,14680757,25624592,40305349,0
1,81,0,1,1,5,30028818,1,28912201,22861940,23399979,75174120,26692283,28203066,54895349,1
1,25,0,3,10,4,30028818,0,34285342,10105698,80076847,124467887,29895358,45964111,75859469,0
1,34,1,5,10,8,53384566,0,28912201,17761046,23399979,70073226,13613064,16575909,30188973,0
1,27,1,3,8,5,30028818,0,28912201,22861940,23399979,75174120,26692283,28203066,54895349,0
1,67,1,3,1,5,18951521,1,22030728,14381802,23399979,59812509,24690361,46444572,71134933,1
1,56,1,2,14,5,30028818,0,28912201,22861940,23399979,75174120,26692283,28203066,54895349,0
1,32,1,4,14,6,22955364,0,14628458,27065976,40038425,81732859,11210759,11819343,23030102,0
1,33,1,8,10,10,10837068,0,22925111,16896216,23399979,63221306,14814218,17200508,32014726,0
1,19,1,2,7,5,30028818,1,28912201,22861940,23399979,75174120,26692283,28203066,54895349,1
0,20,0,0,14,2,53384566,0,28912201,15294678,23399979,67606858,10676913,18802044,29478957,0
1,26,1,4,12,6,30028818,0,53010906,44042267,28827665,125880838,26692283,52850719,79543002,0
1,18,1,3,8,4,18284214,0,79516365,17857138,1601537,98975040,66730708,80076847,146807555,0
1,31,1,1,4,5,30028818,0,28912201,22861940,23399979,75174120,26692283,28203066,54895349,0
1,32,1,2,1,4,46711496,0,24577237,21925041,23399979,69902257,28133665,67264557,95398222,0
1,22,1,2,9,4,20019212,0,28912201,10634206,23399979,62946386,17349985,52530415,69880400,0
1,40,1,6,7,9,36034582,0,34766083,12540034,23399979,70706096,42707653,16175524,58883177,0
1,46,0,3,9,5,30028818,1,28912201,22861940,23399979,75174120,26692283,28203066,54895349,1
1,19,1,2,12,5,30028818,0,28912201,22861940,23399979,75174120,26692283,28203066,54895349,0
1,35,1,7,5,5,30028818,0,28912201,22861940,23399979,75174120,26692283,28203066,54895349,0
1,34,1,3,10,5,2268844,0,1937988,36138681,86483002,124559671,1134422,22501595,23636017,0
1,24,1,3,10,5,77474351,0,71255737,52049953,6406148,129711838,1601537,28443296,30044833,0
1,20,1,2,10,4,11210759,0,28912201,19666875,23399979,71979055,26692283,43721962,70414245,0
1,21,1,1,7,3,45376883,1,28912201,13452911,23399979,65765091,41373043,46092236,87465279,1
1,33,1,2,7,5,30028818,0,28912201,22861940,23399979,75174120,26692283,28203066,54895349,0
1,35,1,3,10,5,6406148,0,53010906,16575908,23399979,92986793,66730708,33632276,100362984,0
1,34,1,3,14,5,30028818,0,28912201,22861940,23399979,75174120,26692283,28203066,54895349,0
1,31,1,4,10,5,30028818,0,28912201,22861940,23399979,75174120,26692283,28203066,54895349,0
1,22,1,5,9,7,88084536,0,62030194,28555405,23399979,113985578,40705733,24343363,65049096,0
1,23,1,2,9,4,29895358,0,41303144,79276085,23399979,143979208,14680755,24503517,39184272,0
1,17,1,1,9,5,30028818,0,28912201,22861940,23399979,75174120,26692283,28203066,54895349,0
1,56,1,3,7,5,30028818,0,28912201,22861940,23399979,75174120,26692283,28203066,54895349,0
1,22,1,2,9,4,66730709,0,26505453,11851374,23399979,61756806,20553057,18625875,39178932,0
1,41,0,5,14,8,21353827,0,74345665,51169107,48046108,173560880,15481524,4617231,20098755,0
1,28,0,3,13,4,30028818,0,28912201,63020483,23399979,115332663,14680755,24055086,38735841,0
1,45,1,1,10,5,30028818,0,28912201,22861940,23399979,75174120,26692283,28203066,54895349,0
1,26,1,3,11,5,10276529,0,37172832,12171681,23399979,72744492,98361063,20147335,118508398,0
1,26,1,3,9,5,40038424,0,12390944,61595111,23399979,97386034,10676913,81678391,92355304,0
1,29,1,1,3,3,86749926,0,28912201,63260712,23399979,115572892,25357668,25944899,51302567,0
1,41,1,4,8,6,3203074,0,16729337,11755282,80076851,108561470,26692283,5765533,32457816,0
1,58,0,1,9,4,30028818,1,16521257,18417676,23399979,58338912,18684598,15374755,34059353,1
1,22,1,5,11,7,11878066,0,23855212,17136446,6406148,47397806,69399935,33952583,103352518,0
1,22,1,1,7,3,10676913,0,28912201,51249184,23399979,103561364,18684598,74631624,93316222,0
1,58,0,0,1,2,53384566,0,14387782,99615601,16015369,130018752,26692283,48046112,74738395,0
1,29,1,3,8,5,16135486,0,53906201,13428888,23399979,90735068,422005,11923443,12345448,0
1,23,1,3,10,5,21353827,0,17142671,11851374,23399979,52394024,80076847,23862902,103939749,0
1,24,1,0,5,3,46711493,1,17514398,21540672,23399979,62455049,18684598,97693758,116378356,1
0,35,1,7,10,5,30028818,0,28912201,22861940,23399979,75174120,26692283,28203066,54895349,0
1,49,0,1,11,2,56053796,0,28912201,34272891,23399979,86585071,40038424,52530415,92568839,0
1,40,0,1,8,3,43775349,0,45433456,25784744,23399979,94618179,50715337,36995506,87710843,0
1,21,1,1,9,3,36034582,0,82606287,10810374,23399979,116816640,40038424,23942978,63981402,0
1,41,1,6,7,8,10676913,0,82606287,68545784,11531066,162683137,72069163,16816139,88885302,0
0,21,0,1,10,3,30028818,0,28912201,49087109,23399979,101399289,33365355,53811642,87176997,0
1,32,1,2,9,4,14947679,0,47606387,33712354,22421518,103740259,30696127,62139637,92835764,0
1,28,1,2,10,4,33365355,0,13252727,20691858,23399979,57344564,70734549,36034584,106769133,0
1,34,1,3,10,5,42707653,0,5184104,39718118,23399979,68302201,33365355,43561806,76927161,0
1,51,1,7,9,11,4874011,0,10738818,37796274,48046108,96581200,16642637,83440079,100082716,0
1,22,1,4,7,6,10009606,0,63678284,33792432,48046112,145516828,36835351,99823799,136659150,0
1,32,1,6,6,8,30028818,0,40412497,12011527,64061478,116485502,23355746,14253679,37609425,0
1,56,1,0,7,2,6406148,0,94314049,20419597,23399979,138133625,35367274,26713636,62080910,0
0,81,0,1,16,2,30028818,0,28912201,45643803,23399979,97955983,66730708,88084536,154815244,0
1,30,1,3,9,5,18684598,1,37172832,23222287,16015369,76410488,14680755,40999348,55680103,1
1,20,1,2,8,3,10943837,0,41303144,21028181,23399979,85731304,21353827,37395889,58749716,0
1,28,1,4,8,6,28026898,1,39586432,22341441,23399979,85327852,20019212,72069163,92088375,1
1,27,1,3,9,5,56053796,0,22443761,50688647,23399979,96532387,262919,13853295,14116214,0
1,24,1,2,12,4,22154593,0,91907303,74471474,48046108,214424885,80076849,44714912,124791761,0
1,39,0,4,7,5,30028818,1,28912201,22861940,23399979,75174120,26692283,28203066,54895349,1
1,43,1,2,8,4,19712252,0,10325787,31790509,23399979,65516275,28347204,36675198,65022402,0
0,27,1,0,10,2,13813256,0,33042515,2445547,23399979,58888041,25357668,28026897,53384565,0
1,31,1,3,10,5,30028818,0,28912201,22861940,23399979,75174120,26692283,28203066,54895349,0
1,48,1,2,1,5,30028818,0,28912201,22861940,23399979,75174120,26692283,28203066,54895349,0
1,30,1,6,8,8,51249185,1,28912201,17937215,23399979,70249395,66730708,1345291,68075999,1
1,29,1,5,9,7,36034582,0,53694088,61178715,23399979,138272782,17349985,60538097,77888082,0
1,36,0,2,3,3,93422985,0,41303144,65663017,23399979,130366140,52049953,96092218,148142171,0
1,25,1,4,10,6,35233814,1,69396747,53608246,23399979,146404972,1601537,16655985,18257522,1
1,38,1,0,8,2,26692283,0,82606287,42440731,23399979,148446997,26692283,62459941,89152224,0
1,34,1,6,8,10,20019212,0,28157883,32351047,1601537,62110467,84748001,34465076,119213077,0
1,27,1,3,10,5,18684598,0,6712542,27962836,96092216,130767594,33365355,62780251,96145606,0
1,19,1,2,10,5,30028818,0,28912201,22861940,23399979,75174120,26692283,28203066,54895349,0
0,61,0,0,9,5,30028818,0,28912201,22861940,23399979,75174120,26692283,28203066,54895349,0
1,28,1,9,8,12,33365355,0,16521257,21620749,23399979,61541985,3122997,13132604,16255601,0
1,47,1,3,5,5,30028818,0,28912201,22861940,23399979,75174120,26692283,28203066,54895349,0
1,22,1,4,9,7,33365355,0,28912201,23702748,23399979,76014928,8505496,21652781,30158277,0
1,20,1,2,9,4,30028818,0,30635769,82479156,72069163,185184088,59924173,33087753,93011926,0
1,28,1,4,10,6,46711493,0,28912201,14654063,23399979,66966243,13346142,10089684,23435826,0
1,25,1,2,9,4,40038425,0,28912201,13565018,23399979,65877198,12812296,15935293,28747589,0
1,26,1,2,10,4,30028818,0,28912201,10490067,23399979,62802247,2936151,59417023,62353174,0
1,30,1,5,10,7,30028818,1,28912201,11418959,23399979,63731139,30696124,16976292,47672416,1
1,29,0,4,10,5,30028818,1,28912201,22861940,23399979,75174120,26692283,28203066,54895349,1
1,27,1,2,8,5,30028818,0,28912201,22861940,23399979,75174120,26692283,28203066,54895349,0
1,40,1,1,5,3,94624138,1,36350497,26265207,3203074,65818778,93422991,32014725,125437716,1
1,37,1,6,4,9,42707653,0,76069229,11162713,19218445,106450387,40038425,28587435,68625860,0
0,35,0,0,8,1,5765533,0,28912201,72069168,11210759,112192128,40038425,10249837,50288262,0
0,30,0,1,10,2,30028818,0,22375139,13773218,23399979,59548336,80076849,27226129,107302978,0
0,36,1,1,8,5,30028818,0,28912201,22861940,23399979,75174120,26692283,28203066,54895349,0
1,58,0,0,1,2,37369196,0,19929549,14461879,23399979,57791407,56053796,39718117,95771913,0
1,45,1,6,9,5,30028818,0,28912201,22861940,23399979,75174120,26692283,28203066,54895349,0
0,39,0,2,6,5,30028818,0,28912201,22861940,23399979,75174120,26692283,28203066,54895349,0
1,34,1,3,10,5,30028818,0,28912201,22861940,23399979,75174120,26692283,28203066,54895349,0
1,25,1,2,10,5,30028818,0,28912201,22861940,23399979,75174120,26692283,28203066,54895349,0
1,46,1,6,10,5,30028818,0,28912201,22861940,23399979,75174120,26692283,28203066,54895349,0
1,29,1,3,12,5,30028818,0,28912201,55973718,23399979,108285898,37903042,72389473,110292515,0
1,35,1,5,7,7,51249185,0,73662476,19490706,3203074,96356256,52049952,19186413,71236365,0
1,40,1,2,1,5,77407622,0,36522855,172966,80076847,116772668,61392248,83279924,144672172,0
1,20,1,2,10,4,15748446,1,54732263,24087117,23399979,102219359,58723027,19474689,78197716,1
1,28,0,4,10,5,34166121,0,75386055,12748235,23399979,111534269,18684598,18898136,37582734,0
1,48,1,3,9,7,10676913,0,13906433,49423431,48046112,111375976,17883829,69827011,87710840,0
1,21,1,2,10,4,11677875,0,57824402,19138367,72069163,149031932,26692283,13709157,40401440,0
1,25,1,3,10,5,30028818,1,28912201,22861940,23399979,75174120,26692283,28203066,54895349,1
1,28,1,2,10,4,30028818,0,41303146,46476605,24023054,111802805,34699969,49167187,83867156,0
1,35,0,2,8,3,24690361,0,6608503,10153745,80076847,96839095,66730708,42280579,109011287,0
1,52,1,1,8,4,30028818,0,10602181,64061478,23399979,98063638,26692283,22421517,49113800,0
1,28,1,2,14,4,32084126,0,61954716,37203704,23399979,122558399,10009606,46764881,56774487,0
1,32,1,6,8,8,35233815,0,41303144,24823824,23399979,89526947,11611143,3074951,14686094,0
1,32,1,0,1,2,84080696,0,37172832,22421518,23399979,82994329,19351906,18898136,38250042,0
1,20,1,3,10,6,13346142,0,72460321,25544514,23399979,121404814,36701891,12491988,49193879,0
1,61,0,0,1,5,30028818,1,28912201,22861940,23399979,75174120,26692283,28203066,54895349,1
1,49,1,6,10,9,18684598,0,82606287,67264557,23399979,173270823,69399939,31710432,101110371,0
1,35,1,5,10,8,6406148,0,10498143,21941057,23399979,55839179,15081141,99695679,114776820,0
0,66,0,0,9,1,57254949,0,2833024,28026898,23399979,54259901,14894294,51249184,66143478,0
1,63,1,3,10,6,53384566,0,54972632,17456754,23399979,95829365,24023056,10730298,34753354,0
1,31,1,3,10,5,30028818,1,28912201,22861940,23399979,75174120,26692283,28203066,54895349,1
1,37,0,6,10,5,30028818,0,28912201,22861940,23399979,75174120,26692283,28203066,54895349,0
1,27,1,4,10,5,30028818,0,28912201,22861940,23399979,75174120,26692283,28203066,54895349,0
1,20,1,2,12,5,30028818,0,28912201,22861940,23399979,75174120,26692283,28203066,54895349,0
1,31,1,3,9,5,6406148,1,45433456,2054772,3203074,50691302,18684598,17616907,36301505,1
1,28,1,5,8,5,30028818,0,28912201,22861940,23399979,75174120,26692283,28203066,54895349,0
1,49,0,2,8,5,30028818,1,28912201,22861940,23399979,75174120,26692283,28203066,54895349,1
1,23,1,1,10,3,10676913,1,20206248,7527224,23399979,51133451,13679795,94170372,107850167,1
1,21,1,3,2,6,80076847,0,34766083,33392047,23399979,91558109,10676913,17136446,27813359,0
1,87,0,0,6,1,53384566,1,69532166,34433044,23399979,127365189,53384566,51249185,104633751,1
0,45,0,0,9,1,13346142,0,28912201,11531066,23399979,63843246,10009606,72069163,82078769,0
1,24,0,3,10,5,93422985,0,37172832,22037149,3203074,62413055,12678834,19538752,32217586,0
1,35,0,5,9,6,80076849,0,28912201,10890452,25624592,65427245,10676913,9849453,20526366,0
1,19,1,1,9,5,30028818,0,28912201,22861940,23399979,75174120,26692283,28203066,54895349,0
1,25,1,2,14,4,10276529,1,28912201,69666862,23399979,121979042,14680755,11370913,26051668,1
1,46,0,0,12,1,71535316,0,388964,61659176,23399979,85448119,58189178,16335678,74524856,0
1,38,0,4,10,6,42707653,1,41303144,16495831,23399979,81198954,26692283,60858407,87550690,1
1,30,1,4,14,6,65396094,0,82606287,36819336,43241501,162667124,53384566,16015369,69399935,0
1,28,1,2,9,4,20553058,0,15662598,13773218,23399979,52835795,73403776,81678391,155082167,0
1,22,1,3,9,5,30028818,0,28912201,22861940,23399979,75174120,26692283,28203066,54895349,0
1,30,1,4,10,6,80076847,0,19965268,16912231,23399979,60277478,26692283,85041618,111733901,0
1,48,1,3,9,5,53384566,0,12390944,27706589,23399979,63497512,21353826,54452259,75806085,0
0,54,0,5,11,5,30028818,0,28912201,22861940,23399979,75174120,26692283,28203066,54895349,0
1,22,1,2,10,4,30028818,1,41303144,18417676,23399979,83120799,28694205,28603451,57297656,1
1,22,1,4,9,6,48046109,1,82606287,18385645,23399979,124391911,57388411,68385628,125774039,1
1,34,1,2,10,4,20019213,0,5927561,24343362,32030739,62301662,25357668,56053796,81411464,0
1,20,1,3,9,5,42707653,0,33042515,10570144,3203074,46815733,53384566,41639961,95024527,0
1,24,1,5,10,7,1601537,1,12390944,59096716,43241501,114729161,13346142,49647648,62993790,1
1,23,1,2,10,4,30389163,0,16797653,25944901,23399979,66142533,53384566,25384361,78768927,0
1,19,1,1,10,3,26692283,0,2581633,21780904,23399979,47762516,20019212,42921192,62940404,0
1,35,0,7,10,8,92088377,0,28912201,16095447,23399979,68407627,80076849,16495831,96572680,0
1,21,1,3,11,5,3203074,0,11600601,24103131,48046112,83749844,60057635,736707,60794342,0
1,40,1,2,9,7,42707653,0,18553818,249039,28827667,47630524,10543451,53811642,64355093,0
1,24,1,2,10,4,69399939,0,65401855,18225491,40038425,123665771,14413833,47085186,61499019,0
1,61,1,4,6,6,40038424,0,12390944,30269049,23399979,66059972,52049952,16415754,68465706,0
0,45,0,0,14,1,69933782,0,41303144,13052527,1601537,55957208,34166121,12780265,46946386,0
1,22,1,1,10,3,12812296,0,82606287,14814217,23399979,120820483,56053796,75272241,131326037,0
1,31,0,3,10,4,10276529,0,28912201,25464438,11210759,65587398,21754211,5123317,26877528,0
0,56,0,0,6,5,30028818,0,28912201,22861940,23399979,75174120,26692283,28203066,54895349,0
1,19,1,1,9,3,49647646,0,28912201,28459314,44843037,102214552,41373043,7094809,48467852,0
0,41,0,0,14,5,30028818,1,28912201,22861940,23399979,75174120,26692283,28203066,54895349,1
1,37,1,5,10,8,42707653,0,28912201,18177444,23399979,70489624,21086905,25640608,46727513,0
1,18,1,3,10,5,30028818,0,28912201,22861940,23399979,75174120,26692283,28203066,54895349,0
1,21,1,0,1,2,53384566,0,41303144,13292757,23399979,77995880,22688441,16976292,39664733,0
0,42,0,1,11,5,30028818,0,28912201,22861940,23399979,75174120,26692283,28203066,54895349,0
1,34,1,3,5,5,54719181,1,11428244,81678391,23399979,116506614,42440729,15214602,57655331,1
1,22,1,1,14,3,26692283,0,28912201,17216522,23399979,69528702,69399939,70467629,139867568,0
1,24,1,3,9,5,30028818,1,30635769,2642536,64061478,97339783,26692283,54452259,81144542,1
1,28,1,2,10,4,39237657,0,16521257,26905823,23399979,66827059,64862247,16495831,81358078,0
1,60,0,0,1,4,33365355,0,82606287,18417675,23399979,124423941,26692283,13773218,40465501,0
1,19,1,1,10,3,30028818,0,28912201,19218443,23399979,71530623,20019212,49727722,69746934,0
1,43,1,5,9,7,24289978,1,19676268,36515042,13613065,69804375,1601537,43241501,44843038,1
1,23,1,4,10,6,38370156,0,12254308,18321584,23399979,53975871,1245195,40198578,41443773,0
0,22,1,2,8,5,30028818,0,28912201,22861940,23399979,75174120,26692283,28203066,54895349,0
1,44,1,8,13,5,30028818,0,28912201,22861940,23399979,75174120,26692283,28203066,54895349,0
1,33,1,4,17,5,30028818,0,28912201,22861940,23399979,75174120,26692283,28203066,54895349,0
1,18,1,2,10,3,30028818,0,28912201,14894295,23399979,67206475,76073008,20499674,96572682,0
1,20,1,2,8,4,69666858,0,53694088,15294678,3203074,72191840,12011528,39237656,51249184,0
1,65,0,1,1,2,10676913,0,12390944,52850719,23399979,88641642,58723027,59256868,117979895,0
1,28,1,6,10,5,30028818,0,28912201,22861940,23399979,75174120,26692283,28203066,54895349,0
1,24,1,4,9,6,93422991,0,22375139,35506076,23399979,81281194,20686522,61931435,82617957,0
1,35,0,2,9,4,93689919,0,21858374,24295316,23399979,69553669,93422985,49375385,142798370,0
1,26,1,5,7,5,30028818,0,28912201,22861940,23399979,75174120,26692283,28203066,54895349,0
1,35,1,7,10,9,45910726,1,41303146,5925687,23399979,70628812,14013449,10249837,24263286,1
1,24,1,2,10,5,30028818,0,28912201,22861940,23399979,75174120,26692283,28203066,54895349,0
1,28,1,1,9,3,30028818,0,24781887,84881462,23399979,133063328,93422991,13693141,107116132,0
1,26,1,8,10,10,27626514,0,34285342,18017291,1601537,53904170,73136854,40198578,113335432,0
1,55,1,4,1,5,30028818,0,28912201,22861940,23399979,75174120,26692283,28203066,54895349,0
1,52,0,4,9,6,53384566,1,52667108,33632278,16015369,102314755,3203074,13661111,16864185,1
1,17,1,2,8,5,30028818,0,28912201,22861940,23399979,75174120,26692283,28203066,54895349,0
1,17,1,4,7,5,30028818,1,28912201,22861940,23399979,75174120,26692283,28203066,54895349,1
1,25,1,3,9,5,42707653,0,11496563,27033945,23399979,61930487,83413382,4956757,88370139,0
1,47,1,1,12,3,524837,0,37589594,15871231,23399979,76860804,36835351,36643166,73478517,0
1,28,0,2,10,3,40038424,0,28912201,62459942,6406148,97778291,60057635,33792431,93850066,0
1,18,1,2,8,5,30028818,0,28912201,22861940,23399979,75174120,26692283,28203066,54895349,0
1,28,1,3,10,5,13346142,0,28912201,22261365,23399979,74573545,20019212,12812296,32831508,0
0,22,1,2,11,5,30028818,1,28912201,22861940,23399979,75174120,26692283,28203066,54895349,1
0,24,0,0,8,1,48046112,0,28912201,41639961,23399979,93952141,10676913,30429204,41106117,0
1,30,1,3,10,5,25624592,0,16521257,74471474,23399979,114392710,26692283,11531066,38223349,0
1,43,0,3,10,4,21353827,0,17555701,14173602,16015369,47744672,26692283,30108896,56801179,0
1,25,1,1,9,4,30696127,0,69532166,2033952,6406148,77972266,11063951,69778969,80842920,0
1,24,1,2,11,4,21353827,0,84060925,33872507,32030739,149964171,26692283,13773218,40465501,0
1,19,1,0,7,2,30028818,0,28912201,17456754,1601537,47970492,43775347,11130682,54906029,0
1,28,1,2,10,4,25624592,0,28912201,13452911,23399979,65765091,15348064,83279924,98627988,0
1,30,1,3,12,5,33365355,0,29878326,23702748,23399979,76981053,76740313,70067245,146807558,0
1,50,1,2,12,5,18417675,1,34421674,26825745,96092224,157339643,62726865,3331197,66058062,1
1,26,1,2,5,3,24023056,0,54491589,80877617,23399979,158769185,1601537,31229971,32831508,0
1,71,1,3,1,7,64728785,0,13425084,66944244,23399979,103769307,13025835,65663018,78688853,0
1,32,1,2,10,4,49380727,0,5714122,15534909,23399979,44649010,93422991,16495831,109918822,0
1,25,0,1,11,2,30028818,0,28912201,48846878,23399979,101159058,26692283,19618828,46311111,0
1,25,1,4,8,6,2012598,0,75386055,2314221,16015369,93715645,2936151,58616253,61552404,0
1,37,1,6,14,8,50715337,0,20651573,1473414,23399979,45524966,75405703,73510551,148916254,0
1,27,1,3,10,5,30028818,0,82606287,19138367,23399979,125144633,30802896,60858407,91661303,0
1,34,0,5,7,6,3203074,0,16521257,14093526,23399979,54014762,27759975,15214602,42974577,0
1,66,1,0,3,3,28026898,0,24095888,11290836,23399979,58786703,10543453,5365149,15908602,0
1,31,1,1,13,5,30028818,0,28912201,22861940,23399979,75174120,26692283,28203066,54895349,0
1,20,1,3,7,5,30028818,0,28912201,22861940,23399979,75174120,26692283,28203066,54895349,0
1,47,1,4,1,7,25624592,0,80199539,15534909,23399979,119134427,22421517,20499674,42921191,0
1,27,1,5,10,7,48046112,0,10151259,13532988,23399979,47084226,12011527,16736061,28747588,0
1,30,1,0,9,2,40038424,0,28912201,10426006,23399979,62738186,68065324,736707,68802031,0
1,53,0,2,9,3,42707653,0,13148688,26024976,24023054,63196718,80076847,23286348,103363195,0
1,32,1,5,8,7,13346142,1,86736603,25784744,80076851,192598198,15334717,52370258,67704975,1
1,23,1,2,10,4,13346142,0,28912201,14413833,23399979,66726013,66730708,17376677,84107385,0
0,38,0,1,9,2,22955363,0,28912201,17616907,23399979,69929087,73804164,1601537,75405701,0
1,61,1,3,8,5,16816138,0,65851208,54996783,40038424,160886415,1601537,10970529,12572066,0
1,43,1,3,10,5,33365354,0,16521257,62459942,23399979,102381178,12011528,10249837,22261365,0
1,24,1,3,10,5,74738393,0,41303144,78475311,23399979,143178434,53918409,69666858,123585267,0
1,42,1,7,8,9,69399939,1,24781887,18978214,23399979,67160080,18684598,26505438,45190036,1
1,22,1,2,8,4,6406148,1,82606287,22861940,23399979,128868206,73403776,76073008,149476784,1
1,52,1,5,11,5,30028818,0,28912201,22861940,23399979,75174120,26692283,28203066,54895349,0
1,29,1,3,9,5,3203074,0,16521257,16736061,23399979,56657297,20286135,84881458,105167593,0
1,36,0,3,14,4,11477681,0,42650009,26345285,23399979,92395273,46711493,65983322,112694815,0
1,22,1,3,6,5,6406148,0,47157024,21588719,40038424,108784167,28293822,28747589,57041411,0
1,23,1,1,4,3,98761444,0,2592037,22741826,88084536,113418399,66730709,26105053,92835762,0
1,23,1,3,12,5,30028818,0,20651573,1145099,23399979,45196651,15935293,50096077,66031370,0
1,34,1,6,10,8,14013449,0,57824402,21700827,88084536,167609765,14680755,78155006,92835761,0
1,39,1,4,10,6,93422991,0,36522855,26185129,23399979,86107963,13346142,3843689,17189831,0
1,17,1,2,4,5,30028818,0,28912201,22861940,23399979,75174120,26692283,28203066,54895349,0
1,25,1,3,6,5,14947679,0,71425879,39237656,23399979,134063514,53384566,10714282,64098848,0
1,81,0,0,1,2,54719181,1,16521257,26105053,23399979,66026289,26692283,14413833,41106116,1
1,29,1,3,10,5,13879988,0,28157883,79836621,19218445,127212949,15348064,19859058,35207122,0
1,24,1,3,9,5,30028818,0,28912201,22861940,23399979,75174120,26692283,28203066,54895349,0
1,20,1,3,10,5,21353827,0,11187569,23062132,23399979,57649680,80076847,22021133,102097980,0
1,28,1,2,7,4,13105911,0,28912201,32991661,23399979,85303841,1601537,20819981,22421518,0
1,40,1,4,6,5,30028818,0,28912201,22861940,23399979,75174120,26692283,28203066,54895349,0
1,36,1,4,10,5,30028818,0,28912201,22861940,23399979,75174120,26692283,28203066,54895349,0
1,40,1,2,9,4,58723021,0,41303144,27626514,16015369,84945027,26692283,28267128,54959411,0
1,35,1,2,10,4,10676913,0,17900111,17344646,23399979,58644736,26692283,17616907,44309190,0
1,29,1,4,12,6,1601537,0,20651573,33023694,23399979,77075246,36701891,26265207,62967098,0
1,42,0,3,4,5,30028818,1,28912201,22861940,23399979,75174120,26692283,28203066,54895349,1
1,18,1,3,10,4,72069163,1,82606287,16736061,23399979,122742327,26692283,15294679,41986962,1
1,25,1,3,10,5,18684598,0,38415656,21941057,48046108,108402821,10676913,17937214,28614127,0
1,26,1,6,4,8,34699969,0,35111401,49327339,19698906,104137646,53384566,12652143,66036709,0
1,28,1,4,8,6,52049952,0,34766083,2033952,23399979,60200014,18417675,1345291,19762966,0
0,33,1,2,10,4,25357668,0,20651573,14958356,19218445,54828374,1321268,12139651,13460919,0
1,21,1,2,10,5,30028818,0,28912201,22861940,23399979,75174120,26692283,28203066,54895349,0
1,25,0,6,8,7,44042268,0,28912201,7735424,23399979,60047604,80076851,93689919,173766770,0
1,18,1,2,11,3,30028818,0,41303144,35233815,23399979,99936938,26024976,14413833,40438809,0
1,26,1,4,10,6,67531476,0,41303144,12812296,23399979,77515419,93422991,1145099,94568090,0
1,25,1,4,6,7,30028818,1,26505453,9689299,23399979,59594731,20019212,10650221,30669433,1
1,65,1,1,10,5,6406148,0,69741156,14333755,23399979,107474890,86749923,21780903,108530826,0
1,27,0,5,12,5,30028818,0,28912201,22861940,23399979,75174120,26692283,28203066,54895349,0
1,23,1,2,10,4,30028818,1,26505453,48046108,23399979,97951540,26692283,12011527,38703810,1
1,23,1,3,14,5,30028818,0,28912201,22861940,23399979,75174120,26692283,28203066,54895349,0
1,29,1,3,9,5,10676913,0,41303144,18257521,23399979,82960644,44042268,78475313,122517581,0
0,29,1,4,13,5,30028818,0,28912201,22861940,23399979,75174120,26692283,28203066,54895349,0
1,29,1,1,10,3,48046112,1,28912201,36515042,23399979,88827222,62726865,58776409,121503274,1
1,40,1,0,7,2,11744605,0,41303144,16415755,6406148,64125047,40038424,49647646,89686070,0
1,41,0,4,8,7,26692283,1,40653168,10313898,25624592,76591658,38703811,18289553,56993364,1
1,34,1,5,8,5,30028818,0,28912201,22861940,23399979,75174120,26692283,28203066,54895349,0
0,36,1,1,14,3,46711493,0,15077211,19026259,23399979,57503449,20019213,32831509,52850722,0
1,23,1,1,14,3,56053796,0,11841276,44522729,23399979,79763984,25357668,52210106,77567774,0
0,42,0,0,10,5,30028818,0,28912201,22861940,23399979,75174120,26692283,28203066,54895349,0
1,25,1,4,7,6,66597252,1,6712542,37556042,11210759,55479343,2268844,5717487,7986331,1
1,57,1,5,9,9,325112,0,25334981,39397809,23399979,88132769,3203074,24343363,27546437,0
1,32,1,4,9,6,20152674,0,17555701,27610498,23399979,68566178,50715337,29788588,80503925,0
1,31,1,3,10,5,23222287,0,21617395,2857142,23399979,47874516,11611143,24023054,35634197,0
1,24,1,4,8,6,21353827,0,82606287,22341441,23399979,128347707,26692283,2642536,29334819,0
1,21,1,2,10,4,42707653,0,18726175,26185129,23399979,68311283,28694205,20659828,49354033,0
1,44,1,5,12,5,30028818,0,28912201,22861940,23399979,75174120,26692283,28203066,54895349,0
1,23,1,2,10,5,30028818,0,28912201,22861940,23399979,75174120,26692283,28203066,54895349,0
1,42,1,1,8,3,37369196,0,16521257,14894295,23399979,54815531,40038425,13613065,53651490,0
1,22,1,2,10,4,17349984,0,28912201,2445547,23399979,54757727,37903044,48046112,85949156,0
1,25,1,5,6,7,12812296,1,28912201,12251758,16015369,57179328,66730709,64702095,131432804,1
0,37,0,0,14,5,30028818,0,28912201,22861940,23399979,75174120,26692283,28203066,54895349,0
1,25,1,3,10,5,18684598,1,28912201,10009606,23399979,62321786,19805674,88404846,108210520,1
1,21,1,3,11,5,30028818,0,28912201,22861940,23399979,75174120,26692283,28203066,54895349,0
1,41,1,8,9,5,30028818,0,28912201,22861940,23399979,75174120,26692283,28203066,54895349,0
1,31,1,2,12,5,30028818,1,28912201,22861940,23399979,75174120,26692283,28203066,54895349,1
1,20,1,3,16,5,18684598,0,62615582,13163032,16015369,91793983,3203074,39237656,42440730,0
1,41,1,4,10,6,40038424,0,39241721,5243432,11210759,55695912,37502658,25304285,62806943,0
1,21,1,2,14,5,30028818,0,28912201,22861940,23399979,75174120,26692283,28203066,54895349,0
1,28,1,6,7,8,37369196,0,55730682,10329913,23399979,89460574,17349985,35073662,52423647,0
1,37,1,5,8,8,89085493,0,1018915,32671356,88084536,121774807,24023054,47773849,71796903,0
1,26,1,2,8,4,11717913,0,33872006,22821902,11210759,67904667,92088375,40518887,132607262,0
1,21,1,2,8,4,56053796,0,41303144,8979818,23399979,73682941,14680755,61018558,75699313,0
1,24,1,2,10,4,16682676,0,28912201,14173602,12812296,55898099,53384566,42600883,95985449,0
1,18,1,2,10,3,13172642,0,57555164,27242145,12812296,97609605,21620749,2722613,24343362,0
1,51,0,0,6,5,30028818,1,28912201,22861940,23399979,75174120,26692283,28203066,54895349,1
1,19,1,3,9,5,10676913,0,16521257,25624591,83279924,125425772,26692283,10986544,37678827,0
0,48,0,3,6,4,93422985,0,66469196,44602805,55253027,166325028,28026898,23062132,51089030,0
1,32,0,1,8,2,11904758,0,82606287,41319656,56053796,179979739,32497857,64541941,97039798,0
1,44,1,6,9,8,2535767,0,11668919,86803307,23399979,121872205,53384566,96092224,149476790,0
1,37,1,0,1,2,12144989,1,20651573,19522736,23399979,63574288,66730708,54452257,121182965,1
1,28,1,5,10,7,53384566,0,20651573,34753354,23399979,78804906,1134422,2033952,3168374,0
1,42,0,1,7,3,70734549,0,20651573,56854565,23399979,100906117,10676913,89686069,100362982,0
1,22,1,2,10,4,10943836,0,83646683,29644449,60858406,174149538,25357668,43433685,68791353,0
1,60,0,1,9,3,50314951,0,28912201,82479156,23399979,134791336,66730708,23862902,90593610,0
1,34,1,5,7,7,36568427,0,88460167,12956435,23399979,124816581,1601537,16976292,18577829,0
1,43,0,2,8,4,14814218,1,41303144,68545784,23399979,133248907,10076337,26745668,36822005,1
1,73,0,0,4,5,30028818,0,28912201,22861940,23399979,75174120,26692283,28203066,54895349,0
1,36,1,4,9,7,18317579,0,42545969,35153738,23399979,101099686,13346142,88084536,101430678,0
1,34,1,3,10,5,21353827,0,23269824,18737982,44843035,86850841,46444573,3071748,49516321,0
1,32,1,5,7,7,10676913,0,49563774,1165919,23399979,74129672,46711493,12812296,59523789,0
1,30,1,4,9,6,2033952,0,33042515,24215239,56053795,113311549,76073008,53171028,129244036,0
0,35,0,4,10,5,30028818,0,28912201,22861940,23399979,75174120,26692283,28203066,54895349,0
0,33,0,0,9,1,14947679,0,28912201,172966,23399979,52485146,26692283,1321268,28013551,0
1,23,1,3,10,5,46711493,0,1018915,25272253,172966,26464134,28026898,58007671,86034569,0
1,17,1,3,10,5,30028818,1,28912201,22861940,23399979,75174120,26692283,28203066,54895349,1
1,43,1,5,13,5,30028818,0,28912201,22861940,23399979,75174120,26692283,28203066,54895349,0
1,36,1,3,6,5,30028818,0,28912201,22861940,23399979,75174120,26692283,28203066,54895349,0
1,49,0,2,4,5,54986105,1,16521257,17096408,25624592,59242257,24156517,21140289,45296806,1
0,18,1,1,6,2,69399939,0,28912201,1016976,23399979,53329156,10676913,46124264,56801177,0
1,61,0,1,1,4,43735309,0,17314723,73670702,23399979,114385404,26692283,22421518,49113801,0
1,43,1,6,9,10,24023056,0,12390944,13372833,23399979,49163756,80076849,65663018,145739867,0
0,52,1,0,9,2,11157374,0,20206248,12892372,48046112,81144732,34833429,14573987,49407416,0
0,62,0,0,9,2,37369196,0,28912201,17520815,23399979,69832995,33765738,11771297,45537035,0
1,76,0,1,1,2,85415304,0,41303144,1297245,23399979,66000368,12358527,40839195,53197722,0
1,61,1,4,12,5,30028818,1,28912201,22861940,23399979,75174120,26692283,28203066,54895349,1
0,43,0,0,9,5,30028818,0,28912201,22861940,23399979,75174120,26692283,28203066,54895349,0
1,23,1,4,10,6,66730709,0,52667108,25752716,80076847,158496671,20019212,19859058,39878270,0
1,22,1,2,9,4,69399939,0,28912201,83279922,23399979,135592102,13346142,80076847,93422989,0
1,41,1,6,10,8,33365355,0,38002625,37379874,80076847,155459346,15348064,10089683,25437747,0
1,45,0,3,5,6,64061481,0,24781887,69987167,23399979,118169033,26692283,16335678,43027961,0
1,76,0,0,5,1,46711493,0,12390944,11210759,23399979,47001682,10009606,51089029,61098635,0
1,28,1,3,8,5,30028818,0,28912201,22861940,23399979,75174120,26692283,28203066,54895349,0
1,31,1,3,6,5,30028818,1,20651573,60858406,23399979,104909958,16415755,14173602,30589357,1
1,47,1,2,1,5,30028818,0,28912201,22861940,23399979,75174120,26692283,28203066,54895349,0
1,30,1,0,8,2,34699969,0,64853094,28507358,96092216,189452668,48046112,35073662,83119774,0
1,37,0,5,3,7,14680757,1,92590485,21941057,23399979,137931521,18684598,52049953,70734551,1
1,23,1,3,8,5,30028818,0,28912201,22861940,23399979,75174120,26692283,28203066,54895349,0
0,65,0,0,10,1,80076847,0,82606287,22149257,23399979,128155523,26692283,1601537,28293820,0
1,34,1,2,14,5,30028818,0,28912201,22861940,23399979,75174120,26692283,28203066,54895349,0
1,37,1,4,9,7,30028818,0,17383041,18481737,23399979,59264757,14680755,10089684,24770439,0
1,29,1,6,9,5,30028818,0,28912201,22861940,23399979,75174120,26692283,28203066,54895349,0
1,31,0,5,5,5,30028818,1,28912201,22861940,23399979,75174120,26692283,28203066,54895349,1
1,26,1,2,8,5,4217381,0,11668919,29067896,23399979,64136794,33365355,13789233,47154588,0
1,26,1,2,14,5,30028818,0,28912201,22861940,23399979,75174120,26692283,28203066,54895349,0
1,61,1,5,7,8,80076847,0,1886281,12011527,23399979,37297787,10676913,14413833,25090746,0
1,27,1,5,9,7,30028818,1,82606287,17456754,23399979,123463020,3203074,25464437,28667511,1
1,80,0,0,1,1,23088825,0,23510501,30429203,40038424,93978128,24023056,56053796,80076852,0
1,46,0,7,5,8,12812296,0,34766083,8215885,23399979,66381947,88084536,1040999,89125535,0
1,35,0,5,8,6,88084536,0,68742737,2826713,23399979,94969429,78742236,10810375,89552611,0
1,25,1,3,10,5,40038424,0,12390944,29308127,96092224,137791295,1601537,28267128,29868665,0
1,35,1,4,10,6,44843035,0,55417652,10041637,23399979,88859268,24289978,27786667,52076645,0
1,26,1,3,8,5,68065324,0,12390944,32030739,23399979,67821662,74738393,43305561,118043954,0
1,44,0,2,9,5,30028818,0,28912201,22861940,23399979,75174120,26692283,28203066,54895349,0
1,36,1,1,10,3,26692283,0,34698373,40518887,23399979,98617239,80076849,59641239,139718088,0
1,28,1,0,9,2,67531476,0,4547291,14141571,48046112,66734974,13346142,12171681,25517823,0
1,45,1,4,7,6,53384566,0,388964,23222287,23399979,47011230,18684598,15534909,34219507,0
1,49,1,1,9,5,30028818,0,28912201,22861940,23399979,75174120,26692283,28203066,54895349,0
1,37,1,2,10,5,30028818,0,28912201,22861940,23399979,75174120,26692283,28203066,54895349,0
1,25,1,1,14,3,13613065,0,41303144,40390762,48046108,129740014,68065324,36915428,104980752,0
1,45,0,6,8,7,82746086,0,38174982,172966,23399979,61747927,44042268,86483002,130525270,0
1,30,1,4,9,5,30028818,0,28912201,22861940,23399979,75174120,26692283,28203066,54895349,0
1,35,1,4,10,6,42707653,1,24781887,32751431,16015369,73548687,16533201,88645073,105178274,1
1,25,1,1,10,3,34166121,0,16521257,26505438,23399979,66426674,338992,68866089,69205081,0
1,29,1,4,8,6,40038424,0,40893845,32351047,16015369,89260261,42707653,16495831,59203484,0
1,48,1,4,8,5,30028818,0,28912201,22861940,23399979,75174120,26692283,28203066,54895349,0
1,21,1,0,10,2,37369196,1,65401855,33263922,80076847,178742624,27226129,46124264,73350393,1
0,51,0,0,7,1,21353827,0,16521257,7959639,80076847,104557743,12678834,59256868,71935702,0
1,27,1,3,10,5,30028818,0,28912201,22861940,23399979,75174120,26692283,28203066,54895349,0
1,23,1,4,10,6,76873775,0,82606287,47165265,23399979,153171531,28026898,56774487,84801385,0
1,39,1,7,7,5,30028818,0,28912201,22861940,23399979,75174120,26692283,28203066,54895349,0
1,25,1,5,9,5,30028818,0,28912201,22861940,23399979,75174120,26692283,28203066,54895349,0
1,22,1,1,9,3,30028818,0,28912201,24423439,23399979,76735619,13613065,27866743,41479808,0
1,26,1,2,4,5,90753765,0,74345665,76073006,23399979,173818650,66730708,22741825,89472533,0
1,21,1,3,9,5,42707653,0,83646683,24583592,23399979,131630254,30696127,15695063,46391190,0
1,55,0,7,6,5,30028818,1,28912201,22861940,23399979,75174120,26692283,28203066,54895349,1
1,38,0,2,9,3,93422985,0,51287338,49295309,23399979,123982626,25357668,975336,26333004,0
0,23,1,1,8,3,54051876,0,24681276,325112,96092216,121098604,46444573,37155659,83600232,0
1,21,1,1,10,3,28026898,0,87776993,16447784,33632278,137857055,44042268,12011527,56053795,0
1,28,1,5,10,7,10009606,0,96556207,25224208,23399979,145180394,1601537,18417675,20019212,0
1,21,1,0,11,2,39371116,0,28912201,21941057,23399979,74253237,53384566,42600883,95985449,0
1,24,1,5,9,5,30028818,0,28912201,22861940,23399979,75174120,26692283,28203066,54895349,0
1,52,1,4,9,8,53384566,0,3858801,19378598,23399979,46637378,33365355,31229971,64595326,0
1,63,1,0,8,4,10676913,0,20651573,17456754,23399979,61508306,2642536,37075581,39718117,0
0,55,0,2,7,5,30028818,0,28912201,22861940,23399979,75174120,26692283,28203066,54895349,0
0,36,1,4,10,5,30028818,0,28912201,22861940,23399979,75174120,26692283,28203066,54895349,0
1,25,1,0,7,5,30028818,1,28912201,22861940,23399979,75174120,26692283,28203066,54895349,1
0,65,0,0,6,1,13879988,0,28912201,88084536,23399979,140396716,26692283,22421517,49113800,0
1,31,1,3,7,5,28026898,0,24990268,24519531,23399979,72909778,93422991,20019213,113442204,0
1,46,1,1,5,6,10676913,0,50360968,29196021,96092224,175649213,60057635,32671356,92728991,0
1,28,1,3,3,5,53384566,1,65401855,16415755,32030739,113848349,17616907,36515045,54131952,1
1,22,1,3,7,5,17376677,0,1407879,15614986,48046112,65068977,66730709,39878273,106608982,0
1,23,1,1,8,3,71401858,0,78759839,31229971,11210759,121200569,86749923,13613065,100362988,0
0,45,0,2,14,3,11210759,0,73662476,96092216,23399979,193154671,53384566,60858407,114242973,0
1,26,1,4,10,6,1127749,0,73630792,50416385,48046108,172093285,53117642,67312599,120430241,0
1,30,1,3,10,5,30028818,0,28912201,27226129,12812296,68950626,33365355,54292103,87657458,0
1,34,1,4,9,5,30028818,0,28912201,22861940,23399979,75174120,26692283,28203066,54895349,0
1,30,1,6,10,5,30028818,0,28912201,22861940,23399979,75174120,26692283,28203066,54895349,0
1,56,1,2,9,5,6406148,1,41303146,2338244,23399979,67041369,10009606,30429203,40438809,1
1,30,1,1,11,3,72069163,0,62787634,1470211,23399979,87657824,70067244,24983976,95051220,0
1,61,1,5,5,7,6406148,0,82606287,35634198,23399979,141640464,66997629,24535547,91533176,0
1,27,1,4,10,6,56053796,0,33042515,66287613,23399979,122730107,13879987,65823169,79703156,0
1,39,0,2,13,4,21046867,0,22375139,91287605,23399979,137062723,26692283,47405496,74097779,0
1,53,1,6,14,10,11637836,1,7194295,5877641,23399979,36471915,10676913,10409991,21086904,1
1,27,1,1,11,5,30028818,0,28912201,22861940,23399979,75174120,26692283,28203066,54895349,0
1,19,1,1,13,3,13346142,0,24781887,28507358,23399979,76689224,45376883,32351048,77727931,0
1,18,1,1,10,2,43374963,0,34766083,34833429,23399979,92999491,15348064,78155006,93503070,0
1,21,1,2,9,4,28026898,0,20651573,97693756,23399979,141745308,20886711,15663032,36549743,0
1,35,0,1,9,2,73403783,0,20033891,14654063,48046108,82734062,88885307,59256868,148142175,0
1,18,0,1,9,5,30028818,0,28912201,22861940,23399979,75174120,26692283,28203066,54895349,0
1,47,0,1,6,2,1981902,0,24781887,74855843,12812296,112450026,68786016,26985899,95771915,0
1,45,1,10,7,12,14413833,0,64163666,26569498,23399979,114133143,11584451,95291452,106875903,0
1,47,1,4,12,5,30028818,0,28912201,22861940,23399979,75174120,26692283,28203066,54895349,0
1,65,0,1,6,3,24023056,0,35524435,12139651,23399979,71064065,22688441,38436887,61125328,0
1,24,0,1,10,5,30028818,1,28912201,22861940,23399979,75174120,26692283,28203066,54895349,1
1,28,1,1,6,3,57388411,0,86053429,10730298,23399979,120183706,15348064,23942978,39291042,0
1,23,1,3,9,5,22688441,0,41303144,14413834,23399979,79116957,62726867,31358095,94084962,0
1,21,1,2,7,5,30028818,0,28912201,22861940,23399979,75174120,26692283,28203066,54895349,0
1,55,1,3,8,5,53384566,0,28912201,20659827,23399979,72972007,10676913,12892373,23569286,0
1,22,1,2,10,5,30028818,0,28912201,22861940,23399979,75174120,26692283,28203066,54895349,0
0,64,0,0,1,1,12812296,0,28912201,12652142,23399979,64964322,42974577,83279924,126254501,0
1,46,0,2,9,4,33365353,0,5762348,172966,23399979,29335293,56053796,45563728,101617524,0
1,29,1,6,12,5,30028818,0,28912201,22861940,23399979,75174120,26692283,28203066,54895349,0
1,65,1,1,5,3,30028818,0,82606287,17008324,23399979,123014590,49380727,81037773,130418500,0
1,52,1,4,7,6,42707653,1,60514703,29628433,23399979,113543115,80076849,64061478,144138327,1
1,28,1,3,10,5,68599172,0,16521257,13068542,23399979,52989778,66730709,35233814,101964523,0
0,25,1,4,10,5,30028818,0,28912201,22861940,23399979,75174120,26692283,28203066,54895349,0
1,49,1,0,2,5,30028818,1,28912201,22861940,23399979,75174120,26692283,28203066,54895349,1
1,24,1,2,8,4,41373043,0,32219577,23734778,23399979,79354334,80076849,59256868,139333717,0
1,21,0,6,14,5,30028818,0,28912201,22861940,23399979,75174120,26692283,28203066,54895349,0
1,42,1,4,10,5,30028818,1,28912201,22861940,23399979,75174120,26692283,28203066,54895349,1
1,23,0,3,10,5,30028818,1,28912201,96092216,23399979,148404396,72069162,98814831,170883993,1
1,48,1,3,9,7,30028818,0,6712542,10073668,23399979,40186189,45376883,18770014,64146897,0
1,27,1,3,8,5,26024976,0,41303144,11370913,23399979,76074036,26692283,12011527,38703810,0
1,33,1,4,10,6,53384566,0,12254308,41415747,48046108,101716163,17216522,34513123,51729645,0
1,23,1,1,12,3,14680757,0,20033891,30429202,35257837,85720930,45376883,68545784,113922667,0
1,78,1,1,5,3,1601537,0,95902509,16495831,23399979,135798319,93422991,89686069,183109060,0
1,63,0,2,1,5,30028818,0,28912201,22861940,23399979,75174120,26692283,28203066,54895349,0
1,54,1,5,9,8,30028818,0,28912201,22901979,23399979,75214159,29895357,75784729,105680086,0
1,46,0,3,9,5,13346142,0,44750278,21220366,23399979,89370623,2936151,6662394,9598545,0
1,27,1,3,8,5,30028818,0,28912201,22861940,23399979,75174120,26692283,28203066,54895349,0
1,31,1,4,10,6,12011528,0,20651573,34593201,48206264,103451038,50715337,10506083,61221420,0
1,29,1,4,9,6,18017292,0,40997882,17008324,14413833,72420039,11677875,56294025,67971900,0
1,39,1,3,8,5,30028818,0,28912201,22861940,23399979,75174120,26692283,28203066,54895349,0
1,42,1,6,8,5,30028818,0,28912201,22861940,23399979,75174120,26692283,28203066,54895349,0
1,22,1,2,8,4,26158438,1,28912201,1297245,23399979,53609425,27759974,24951946,52711920,1
1,24,1,4,9,6,30028818,0,82606287,19827028,48046112,150479427,20686522,22741825,43428347,0
1,24,1,3,6,5,85415304,0,28912201,10426006,23399979,62738186,43908806,11931451,55840257,0
1,20,1,2,11,5,30028818,0,28912201,22861940,23399979,75174120,26692283,28203066,54895349,0
1,55,1,1,8,5,27546436,0,90866913,35233813,23399979,149500705,17349985,17969246,35319231,0
1,23,1,3,6,5,30028818,0,28912201,22861940,23399979,75174120,26692283,28203066,54895349,0
1,23,1,3,9,5,50715337,0,24749594,36242783,23399979,84392356,93422985,30909664,124332649,0
1,24,1,1,10,3,97426832,0,15041489,33151816,23399979,71593284,21353827,40198578,61552405,0
1,23,1,3,10,5,30028818,0,41303146,31390125,23399979,96093250,26692283,6934655,33626938,0
1,29,1,4,9,6,80076847,0,24781887,29548358,23399979,77730224,56053796,1905829,57959625,0
1,27,1,3,10,5,55386491,0,20033891,16335678,16015369,52384938,22688441,36995506,59683947,0
1,51,0,4,4,5,30028818,0,28912201,22861940,23399979,75174120,26692283,28203066,54895349,0
1,18,1,2,10,3,30028818,0,41303144,3843689,22421518,67568351,38703811,30669434,69373245,0
1,27,1,4,8,6,48046112,0,70215347,23158224,23399979,116773550,14013449,83279924,97293373,0
1,20,1,2,10,5,30028818,0,28912201,22861940,23399979,75174120,26692283,28203066,54895349,0
1,49,1,3,12,5,30028818,0,28912201,22861940,23399979,75174120,26692283,28203066,54895349,0
1,32,0,3,6,4,74738393,0,16521257,52850719,23399979,92771955,3203074,35233815,38436889,0
1,46,0,4,5,10,3203074,0,17142671,19859059,23399979,60401709,89419146,19378597,108797743,0
1,28,1,2,9,4,22554979,0,24781887,17809091,23399979,65990957,25357668,20819981,46177649,0
1,82,0,0,1,2,42707653,0,28912201,43721962,23399979,96034142,18684598,45884033,64568631,0
1,31,1,6,9,8,11744604,0,28912201,39269687,16015369,84197257,33365355,63180634,96545989,0
1,36,0,4,9,5,82746086,1,82606287,2251761,48046108,132904156,30696127,31229971,61926098,1
0,33,1,5,10,5,30028818,0,28912201,22861940,23399979,75174120,26692283,28203066,54895349,0
1,48,0,1,7,5,30028818,0,28912201,22861940,23399979,75174120,26692283,28203066,54895349,0
0,36,0,2,10,3,14947679,0,22375139,1169122,23399979,46944240,3203074,10890451,14093525,0
1,25,0,3,9,5,30028818,0,28912201,22861940,23399979,75174120,26692283,28203066,54895349,0
0,54,1,1,6,3,2936151,0,41303144,10409991,96092224,147805359,20019213,96092224,116111437,0
1,22,1,1,8,5,30028818,0,28912201,22861940,23399979,75174120,26692283,28203066,54895349,0
1,31,1,5,10,7,20553058,1,41303144,26449384,23399979,91152507,73403776,38757195,112160971,1
1,25,1,5,11,7,53384566,0,67916675,91047375,23399979,182364029,11611143,16319662,27930805,0
1,24,1,3,5,5,93422991,1,28912201,96092216,6406148,131410565,20019212,96092224,116111436,1
1,34,1,4,8,5,30028818,0,28912201,22861940,23399979,75174120,26692283,28203066,54895349,0
1,37,1,7,11,10,10276529,0,74353119,51969873,12812296,139135288,37075581,23991025,61066606,0
1,49,1,5,13,7,60057635,0,5714122,30909665,23399979,60023766,25491131,11322867,36813998,0
1,51,1,3,9,8,68332243,0,35524435,27065976,12812296,75402707,32097469,45643803,77741272,0
1,20,1,1,10,3,31056473,0,34698373,25064053,23399979,83162405,43374963,44442654,87817617,0
1,22,1,2,10,4,10676913,0,82606287,21332472,23399979,127338738,80076849,70467629,150544478,0
1,26,1,3,10,5,10009606,0,12390944,25624591,23399979,61415514,14680755,22581671,37262426,0
1,45,0,2,9,3,72869935,0,20446922,23942978,23399979,67789879,2162075,29468281,31630356,0
1,22,1,2,10,4,40038424,0,23129761,51809723,23399979,98339463,72069162,97693758,169762920,0
1,62,0,2,5,3,14413832,1,13252727,15054448,23399979,51707154,93422991,33632276,127055267,1
1,39,1,3,1,5,46711493,0,35524435,78635468,23399979,137559882,66730708,48046112,114776820,0
1,29,1,1,10,3,30028818,1,48880596,97853912,23399979,170134487,14013449,69666858,83680307,1
1,41,1,4,8,6,27759974,0,41303146,26905823,23399979,91608948,36034582,39381794,75416376,0
1,22,1,2,8,4,14680755,0,82606287,14173602,38436887,135216776,26692283,69987168,96679451,0
1,20,1,2,9,4,63394175,0,41303144,26345285,23399979,91048408,50048032,30269049,80317081,0
1,22,1,3,6,5,30028818,0,28912201,23222287,23399979,75534467,21353827,22421518,43775345,0
1,27,1,3,7,6,37369196,0,22375139,172966,80076847,102624952,4417573,11386928,15804501,0
1,30,1,3,1,5,62993789,0,37172832,19298521,23399979,79871332,33365354,17616907,50982261,0
1,19,1,2,10,4,6406148,0,30635769,43241498,3203074,77080341,57388411,16335678,73724089,0
1,36,0,7,1,8,42707653,1,16521257,75592545,19218444,111332246,23889594,63100559,86990153,1
1,23,1,4,10,6,21353827,0,27090842,30557327,23399979,81048148,21353827,67424706,88778533,0
1,31,1,3,9,5,13346142,0,11600601,21619148,23399979,56619728,20019212,14413833,34433045,0
1,24,1,2,9,4,46711493,0,41303146,16864185,23399979,81567310,26692283,30749509,57441792,0
1,25,1,3,10,5,10276529,0,82606287,80877617,23399979,186883883,66730708,12011528,78742236,0
1,33,0,4,10,5,30028818,0,28912201,22861940,23399979,75174120,26692283,28203066,54895349,0
1,25,1,2,3,4,37369196,0,6608503,52850719,23399979,82859201,66730708,12251758,78982466,0
1,33,1,5,7,7,34699969,1,58381232,25704669,23399979,107485880,66730708,30909664,97640372,1
1,59,1,1,1,3,93422985,0,82606287,17584877,23399979,123591143,97426832,87283764,184710596,0
0,28,1,0,9,5,30028818,0,28912201,22861940,23399979,75174120,26692283,28203066,54895349,0
1,65,1,1,5,2,26692283,1,28912201,83279922,23399979,135592102,26692283,11210759,37903042,1
1,36,0,1,9,2,24823823,0,48880596,22261365,23399979,94541940,2936151,19218445,22154596,0
1,22,1,3,9,5,30028818,0,28912201,22861940,23399979,75174120,26692283,28203066,54895349,0
1,22,0,2,7,3,30028818,0,28912201,5765533,23399979,58077713,26692283,28891727,55584010,0
1,20,1,6,9,5,30028818,0,28912201,22861940,23399979,75174120,26692283,28203066,54895349,0
1,20,1,6,10,8,66730709,0,28912201,34721323,23399979,87033503,13346142,75272241,88618383,0
1,30,1,3,10,5,30028818,0,61954716,29067896,23399979,114422591,57388411,19186413,76574824,0
1,21,1,3,10,5,30028818,0,28912201,22861940,23399979,75174120,26692283,28203066,54895349,0
1,29,1,2,9,4,36835351,0,45433456,18065337,33632276,97131069,18444368,40182564,58626932,0
0,49,0,0,10,5,30028818,0,28912201,22861940,23399979,75174120,26692283,28203066,54895349,0
1,32,0,3,9,5,21353827,1,12390944,12892372,23399979,48683295,13346142,20819981,34166123,1
1,26,0,3,7,5,30028818,0,28912201,22861940,23399979,75174120,26692283,28203066,54895349,0
1,26,1,4,11,7,56053796,0,28912201,16591924,23399979,68904104,21086905,18978214,40065119,0
1,24,1,2,9,5,30028818,0,28912201,22861940,23399979,75174120,26692283,28203066,54895349,0
1,30,1,3,10,5,3203074,1,28912201,33632278,23399979,85944458,26692283,20499674,47191957,1
1,27,1,4,9,6,54986105,0,57824402,15823186,96092224,169739812,36301506,32190895,68492401,0
1,38,1,7,10,10,31763816,0,35937466,164638,23399979,59502083,10676913,13933372,24610285,0
1,22,1,2,13,4,30028818,0,20651573,19298521,96092224,136042318,46711496,12652143,59363639,0
1,20,1,3,9,7,58723021,0,5714122,2033952,32030739,39778813,18017291,71268394,89285685,0
1,36,0,1,18,3,40038424,0,36350497,89045456,48046108,173442061,61392255,19378597,80770852,0
1,26,1,3,9,5,52049952,0,22375139,12812296,23399979,58587414,13346142,12972449,26318591,0
1,26,1,4,8,5,30028818,0,28912201,22861940,23399979,75174120,26692283,28203066,54895349,0
1,39,1,8,10,5,30028818,1,28912201,22861940,23399979,75174120,26692283,28203066,54895349,1
0,28,0,1,11,5,30028818,0,28912201,22861940,23399979,75174120,26692283,28203066,54895349,0
0,52,1,0,8,5,30028818,1,28912201,22861940,23399979,75174120,26692283,28203066,54895349,1
1,27,0,3,10,5,30028818,0,28912201,22861940,23399979,75174120,26692283,28203066,54895349,0
1,29,0,4,8,5,30028818,0,28912201,22861940,23399979,75174120,26692283,28203066,54895349,0
0,46,0,0,8,1,16015369,0,28912201,40518887,23399979,92831067,54051876,23862902,77914778,0
1,80,0,0,1,1,26692283,1,82606287,2642536,23399979,108648802,26692283,56053793,82746076,1
0,39,1,5,8,7,11210759,1,17968733,30188971,2722613,50880317,12011528,3763612,15775140,1
1,56,1,0,9,4,10676913,0,20651573,35233813,23399979,79285365,26692283,23382441,50074724,0
1,29,1,2,9,4,45003189,0,23269824,26537469,23399979,73207272,92088375,23542593,115630968,0
1,33,1,3,10,5,53384566,1,20446922,24711716,32030739,77189377,2936151,34032661,36968812,1
1,55,1,0,1,2,30028818,0,34766083,61659176,23399979,119825238,13346142,96092218,109438360,0
1,27,1,4,10,6,38436887,0,33042515,31149893,23399979,87592387,66997633,59256868,126254501,0
1,34,1,7,6,9,82479153,1,83646683,92088379,10249837,185984899,26692283,9849453,36541736,1
1,75,0,1,4,5,30028818,0,28912201,22861940,23399979,75174120,26692283,28203066,54895349,0
1,22,1,3,9,5,93422991,0,17142671,17056369,23399979,57599019,47378802,78795624,126174426,0
1,64,1,5,7,7,12011528,0,16521257,60057636,23399979,99978872,12011528,52850723,64862251,0
1,30,0,3,9,7,90753765,0,16521257,37956427,23399979,77877663,18951522,46925034,65876556,0
1,31,1,5,10,7,21006826,0,63678284,42040347,16015369,121734000,42707653,1169122,43876775,0
1,25,1,2,6,4,12812296,0,12390944,16772897,20819981,49983822,1601537,98974991,100576528,0
1,26,1,2,10,4,60057635,0,14215425,13452911,6406148,34074484,53384566,44522728,97907294,0
1,23,1,4,6,6,26692283,0,94663409,29548358,3203074,127414841,37369196,27546436,64915632,0
1,33,0,5,8,5,30028818,0,28912201,22861940,23399979,75174120,26692283,28203066,54895349,0
1,26,1,4,10,6,48046112,0,34766083,21588719,12812296,69167098,93422994,59577175,153000169,0
1,20,1,5,8,5,30028818,0,28912201,22861940,23399979,75174120,26692283,28203066,54895349,0
1,39,1,2,10,5,30028818,0,28912201,22861940,23399979,75174120,26692283,28203066,54895349,0
1,38,0,8,14,10,11531066,0,84329857,20980135,80076851,185386843,44576116,17072384,61648500,0
1,27,1,2,10,4,12278451,0,69532166,25944901,23399979,118877046,50715337,21556688,72272025,0
1,21,1,3,10,5,56053796,0,22375139,15374756,48046112,85796007,66730708,1145099,67875807,0
1,35,1,3,8,5,55519948,0,24781887,35233814,23399979,83415680,1601537,90486841,92088378,0
1,66,0,0,1,5,30028818,1,28912201,22861940,23399979,75174120,26692283,28203066,54895349,1
1,27,1,4,10,6,27759974,0,12254308,33632278,1040999,46927585,27226129,20919276,48145405,0
1,41,1,4,10,7,66730709,0,61954716,24743747,11210759,97909222,2936151,81838539,84774690,0
1,23,0,3,10,5,30028818,1,28912201,22861940,23399979,75174120,26692283,28203066,54895349,1
1,23,1,4,13,5,30028818,0,28912201,22861940,23399979,75174120,26692283,28203066,54895349,0
1,21,1,4,10,6,26692283,0,26333401,22181288,23399979,71914668,73403776,22821901,96225677,0
1,23,1,2,12,5,30028818,0,28912201,22861940,23399979,75174120,26692283,28203066,54895349,0
0,27,1,3,8,5,30028818,0,28912201,22861940,23399979,75174120,26692283,28203066,54895349,0
1,30,1,3,10,5,56320715,0,28912201,18577829,23399979,70890009,61392255,21300442,82692697,0
1,28,0,3,7,4,18684598,0,28912201,36034584,23399979,88346764,46711496,88084536,134796032,0
1,43,1,8,9,11,52316875,0,43026714,25624591,16015369,84666674,76073008,40935287,117008295,0
1,35,1,5,8,7,90753765,0,54732263,94810989,23399979,172943231,56454177,28827665,85281842,0
1,35,1,2,10,4,10009606,1,47157024,18097368,12812296,78066688,84080696,35666229,119746925,1
1,36,1,2,14,4,14947679,0,16521257,27546436,44042267,88109960,24023056,48046108,72069164,0
1,24,1,3,4,5,38169963,0,75386055,14766171,23399979,113552205,26692283,14413833,41106116,0
1,29,0,3,9,5,30028818,0,28912201,22861940,23399979,75174120,26692283,28203066,54895349,0
1,43,1,5,8,8,13346142,0,48880596,14093526,23399979,86374101,20019212,24023054,44042266,0
1,35,1,6,10,8,36034584,0,75386055,14654063,23399979,113440097,16522522,51329262,67851784,0
1,22,1,2,10,4,30028818,0,28912201,18289552,23399979,70601732,26692283,28106974,54799257,0
1,32,1,2,14,4,30028818,0,28912201,28026897,23399979,80339077,10676913,42440731,53117644,0
1,21,1,2,10,4,21220366,0,45433456,20499673,3203074,69136203,10009606,49887878,59897484,0
1,26,1,5,10,7,10676913,0,47157024,33087753,89686073,169930850,2936151,84881458,87817609,0
1,26,1,3,10,5,31363432,0,33218298,3507366,23399979,60125643,23756132,15855216,39611348,0
1,65,1,0,10,2,10676913,0,24508919,62700172,48046112,135255203,26692283,51249185,77941468,0
1,30,0,1,6,2,60057635,0,19207828,13762007,23399979,56369814,26692283,11210759,37903042,0
1,32,0,0,10,2,18684598,0,37172832,16575908,1601537,55350277,20019212,46604725,66623937,0
1,29,1,4,12,7,69399939,0,41303144,10714282,23399979,75417405,26692283,56053796,82746079,0
1,22,1,2,8,4,12144989,0,5349317,19987181,23399979,48736477,38703811,22581671,61285482,0
1,38,1,5,14,7,68065324,0,26746432,2338244,80076847,109161523,20019212,26265207,46284419,0
1,60,0,1,6,5,30028818,0,28912201,22861940,23399979,75174120,26692283,28203066,54895349,0
1,22,1,2,11,5,30028818,0,28912201,22861940,23399979,75174120,26692283,28203066,54895349,0
1,25,1,1,10,3,93422985,0,16521257,20259444,23399979,60180680,56721101,33071739,89792840,0
1,36,0,2,8,3,53384566,0,20651573,49487492,23399979,93539044,13346142,29548357,42894499,0
1,33,1,1,14,3,93422985,0,3876037,17945222,22421519,44242778,25784746,7799485,33584231,0
1,36,0,4,9,5,30028818,1,28912201,22861940,23399979,75174120,26692283,28203066,54895349,1
1,23,1,0,10,2,30028818,0,82606287,29548358,23399979,135554624,25224209,84881458,110105667,0
1,28,1,5,10,7,48046112,0,82606287,39317734,72069168,193993189,10676913,13725172,24402085,0
1,33,0,4,9,5,30028818,0,28912201,22861940,23399979,75174120,26692283,28203066,54895349,0
1,39,1,0,12,4,10676913,1,11151849,46925034,32030739,90107622,87417221,3614669,91031890,1
1,21,0,3,10,4,30429204,0,20819981,22861940,23097595,66779516,44843035,12283789,57126824,0
1,44,1,6,6,8,16549217,0,1169122,12812296,21194893,35176311,7420455,19971167,27391622,0
1,23,1,1,7,3,30028818,0,12091605,22861940,81644066,116597611,26692283,76153084,102845367,0
1,67,0,0,1,1,30028818,1,32831509,22861940,25749285,81442734,16015369,87283764,103299133,1
1,40,1,4,7,6,14013449,0,15855217,80076851,1481805,97413873,86082611,56053796,142136407,0
1,54,1,2,4,4,85415306,0,34641245,22861940,12325695,69828880,14947679,50928875,65876554,0
1,25,1,6,6,8,38703811,0,63260712,22861940,99903496,186026148,38703811,2642536,41346347,0
1,43,0,6,9,8,61926098,0,32831509,96092224,18364101,147287834,76339931,49855846,126195777,0
1,23,1,2,9,5,30028818,0,28912201,22861940,23399979,75174120,26692283,28203066,54895349,0
1,22,1,2,7,5,30028818,1,28912201,22861940,23399979,75174120,26692283,28203066,54895349,1
1,31,1,3,10,5,24023054,1,34513123,51249184,22923141,108685448,24023054,78475311,102498365,1
1,68,1,1,4,5,30028818,0,28912201,22861940,23399979,75174120,26692283,28203066,54895349,0
1,28,1,2,10,4,13346142,0,16736061,22861940,56197174,95795175,53384566,89686069,143070635,0
1,49,1,3,9,5,15748447,0,40679039,22861940,88854797,152395776,1975229,85041618,87016847,0
1,79,1,0,12,2,66730708,0,14061494,22861940,63268337,100191771,81945305,95291452,177236757,0
1,47,0,3,7,5,40038424,0,19778983,22861940,98670692,141311615,40038424,47245342,87283766,0
1,58,0,2,8,5,30028818,0,28912201,22861940,23399979,75174120,26692283,28203066,54895349,0
1,21,1,2,10,4,30028818,0,13853294,22861940,46893002,83608236,26692283,18577829,45270112,0
1,67,1,0,8,3,10676913,1,25096085,24023054,43241119,92360258,10676913,49487492,60164405,1
1,26,0,3,10,4,30028818,0,18097368,80076847,12511779,110685994,26692283,70627785,97320068,0
0,33,0,3,10,5,30028818,0,28912201,22861940,23399979,75174120,26692283,28203066,54895349,0
1,38,1,11,10,5,30028818,1,28912201,22861940,23399979,75174120,26692283,28203066,54895349,1
1,26,1,3,10,5,1601537,0,22533626,11210759,69083443,102827828,1601537,23302362,24903899,0
1,25,1,2,9,4,46711493,0,19939136,22861940,19306145,62107221,16202215,25544516,41746731,0
1,26,1,4,10,5,30028818,0,28912201,22861940,23399979,75174120,26692283,28203066,54895349,0
0,40,1,0,10,5,30028818,0,28912201,22861940,23399979,75174120,26692283,28203066,54895349,0
1,24,1,3,8,5,12812296,0,31310049,22861940,11583688,65755677,12812296,56534256,69346552,0
1,24,1,5,10,5,30028818,0,28912201,22861940,23399979,75174120,26692283,28203066,54895349,0
1,33,1,7,7,5,30028818,0,28912201,22861940,23399979,75174120,26692283,28203066,54895349,0
1,73,1,2,12,5,12144989,1,16335678,97693758,13525932,127555368,12144989,46604725,58749714,1
1,21,1,1,12,3,15348064,0,24823824,22861940,37670246,85356010,15348064,28026898,43374962,0
1,49,0,3,9,5,30028818,0,28912201,22861940,23399979,75174120,26692283,28203066,54895349,0
1,25,0,3,9,4,26692283,0,2466367,22861940,45125214,70453521,36301506,89686069,125987575,0
1,49,0,3,6,4,14547294,0,86483002,22861940,13630605,122975547,14547294,28203066,42750360,0
1,25,1,2,9,4,28026897,0,37235736,1297245,12316391,50849372,26692283,46444572,73136855,0
1,34,0,0,1,5,30028818,0,28912201,22861940,23399979,75174120,26692283,28203066,54895349,0
1,36,1,6,10,11,45109959,0,51217151,40038424,16131099,107386674,10116375,53010876,63127251,0
1,23,1,3,10,5,48046112,0,35313892,22861940,97112244,155288076,46711493,46156296,92867789,0
1,48,0,3,1,6,13346142,0,87443924,22861940,11299911,121605775,61392255,6406148,67798403,0
1,17,1,3,10,5,30028818,0,28912201,22861940,23399979,75174120,26692283,28203066,54895349,0
1,25,1,3,9,5,40038424,0,18978214,22861940,14940166,56780320,95291452,59417023,154708475,0
1,20,1,2,10,4,27493052,1,54452259,22861940,34774326,112088525,18150753,25464437,43615190,1
1,27,1,4,8,6,46711496,0,11130682,22861940,26109819,60102441,46711496,20980135,67691631,0
1,35,1,8,10,10,68065324,0,80076847,22861940,10523013,113461800,80076847,11771297,91848144,0
1,28,1,6,10,8,20686522,0,7527224,1601537,15269301,24398062,22440203,12812296,35252499,0
1,23,1,4,9,6,26158438,0,22549641,16015369,18445511,57010521,26158435,26905821,53064256,0
1,24,1,2,11,5,30028818,1,28912201,22861940,23399979,75174120,26692283,28203066,54895349,1
1,39,0,1,10,5,30028818,0,28912201,22861940,23399979,75174120,26692283,28203066,54895349,0
1,30,1,2,14,4,3203074,0,27386282,11210759,93739479,132336520,64595323,25704668,90299991,0
1,36,1,8,8,5,30028818,0,28912201,22861940,23399979,75174120,26692283,28203066,54895349,0
1,50,1,0,14,5,30028818,1,28912201,22861940,23399979,75174120,26692283,28203066,54895349,1
1,35,1,1,4,3,56721101,0,12540034,22861940,11996561,47398535,56721101,24423439,81144540,0
1,26,1,4,10,7,30028818,0,19955151,12812296,56941502,89708949,26692283,3331197,30023480,0
1,27,1,7,9,10,15748446,0,19939136,22861940,2440018,45241094,35100353,29516327,64616680,0
1,23,1,3,10,5,17083061,0,53331181,22861940,14214441,90407562,14814217,29628435,44442652,0
1,23,0,3,10,4,30028818,0,1601537,22861940,80248442,104711919,26692283,6630363,33322646,0
0,61,0,0,12,5,30028818,0,28912201,22861940,23399979,75174120,26692283,28203066,54895349,0
0,21,0,0,10,5,30028818,0,28912201,22861940,23399979,75174120,26692283,28203066,54895349,0
1,35,1,3,8,5,17349985,0,3098974,22861940,16491638,42452552,22154596,27546436,49701032,0
1,23,1,2,7,4,30028818,0,18449706,22861940,21855489,63167135,39557965,25624592,65182557,0
1,24,1,2,10,4,34900162,0,1297245,22861940,17817482,41976667,24556902,1905829,26462731,0
1,23,1,1,14,3,19351906,0,69186401,22861940,38647182,130695523,19351906,59897485,79249391,0
1,20,1,2,10,4,20553058,0,64061478,22861940,14080695,101004113,20553058,14573987,35127045,0
1,30,0,8,14,10,16329004,0,20980135,64061481,21726974,106768590,4083252,76713623,80796875,0
1,32,1,5,12,7,80076847,0,82959618,22861940,40124222,145945780,80076847,24983976,105060823,0
1,28,1,1,4,3,30028818,0,10089683,22861940,12330347,45281970,64061475,37443935,101505410,0
1,25,1,4,9,5,30028818,0,28912201,22861940,23399979,75174120,26692283,28203066,54895349,0
1,20,0,2,10,4,17083061,1,7527224,40038424,83295555,130861203,17083061,10249837,27332898,1
1,76,0,0,4,2,24890554,0,32030739,80076851,2309178,114416768,11677873,15214602,26892475,0
1,73,0,1,1,2,54986105,0,20803966,22861940,54871326,98537232,54986105,11803328,66789433,0
1,31,0,6,8,10,60057635,0,76233162,22861940,93855782,192950884,84080696,96092218,180172914,0
1,63,0,1,1,5,30028818,0,28912201,22861940,23399979,75174120,26692283,28203066,54895349,0
0,34,1,6,9,9,30028818,0,12812296,22861940,15386766,51061002,40038424,18689938,58728362,0
1,48,1,4,9,5,30028818,0,28912201,22861940,23399979,75174120,26692283,28203066,54895349,0
1,22,1,1,10,3,53384566,0,2338244,48046112,15654262,66038618,82212238,17344646,99556884,0
1,19,1,1,6,5,30028818,0,28912201,22861940,23399979,75174120,26692283,28203066,54895349,0
1,32,1,3,10,5,10676913,1,26105054,96092216,10176434,132373704,1494768,2722613,4217381,1
1,39,1,9,9,12,4276104,0,33792432,80076847,22492825,136362104,40572273,25464437,66036710,0
1,25,1,3,6,6,26692283,1,13613065,16015369,16794022,46422456,74738398,3843689,78582087,1
1,28,1,4,9,6,14814218,0,49087109,22861940,80318225,152267274,14053487,15663032,29716519,0
1,23,1,4,10,5,30028818,1,28912201,22861940,23399979,75174120,26692283,28203066,54895349,1
1,34,0,0,1,1,26692283,1,16816139,22861940,29424431,69102510,26692283,1601537,28293820,1
1,24,1,2,10,5,79609737,1,19538751,32030739,79841393,131410883,1279895,21796919,23076814,1
1,31,1,4,4,5,30028818,0,28912201,22861940,23399979,75174120,26692283,28203066,54895349,0
1,31,1,3,12,5,30028818,0,28912201,22861940,23399979,75174120,26692283,28203066,54895349,0
1,31,1,6,10,5,30028818,0,28912201,22861940,23399979,75174120,26692283,28203066,54895349,0
1,26,1,3,1,5,30028818,0,28912201,22861940,23399979,75174120,26692283,28203066,54895349,0
1,33,1,5,9,5,30028818,0,28912201,22861940,23399979,75174120,26692283,28203066,54895349,0
1,73,0,0,1,1,16682677,0,12251758,22861940,36786354,71900052,16682677,45643806,62326483,0
1,27,1,2,8,5,30028818,1,28912201,22861940,23399979,75174120,26692283,28203066,54895349,1
1,24,1,3,9,5,30028818,0,28912201,22861940,23399979,75174120,26692283,28203066,54895349,0
1,33,1,0,9,2,38436887,0,26553482,6406148,65245468,98205098,38436887,57495178,95932065,0
1,28,1,5,9,7,87777567,0,25144131,80076849,20537206,125758186,87777567,98414452,186192019,0
1,68,1,1,1,5,30028818,0,28912201,22861940,23399979,75174120,26692283,28203066,54895349,0
1,20,1,4,10,5,30028818,0,28912201,22861940,23399979,75174120,26692283,28203066,54895349,0
1,22,1,3,10,5,30028818,0,28912201,22861940,23399979,75174120,26692283,28203066,54895349,0
1,18,0,4,9,5,30028818,0,28912201,22861940,23399979,75174120,26692283,28203066,54895349,0
1,23,1,2,5,4,2936151,0,13052527,22861940,18947937,54862404,21353827,88084536,109438363,0
1,34,1,3,10,5,30028818,0,28912201,22861940,23399979,75174120,26692283,28203066,54895349,0
1,35,1,4,10,7,14947679,1,20739905,3843689,1242339,25825933,10143068,42120422,52263490,1
1,38,1,5,9,7,90353384,1,67264557,22861940,94983925,185110422,90353384,10970529,101323913,1
1,30,0,4,7,5,46711493,0,60057636,22861940,99694153,182613729,46711493,27418314,74129807,0
1,28,1,2,10,4,48046112,0,19634843,22861940,8965728,51462511,59390326,19955151,79345477,0
1,26,1,4,7,6,26692283,0,35169754,22861940,87063751,145095445,47512269,82479156,129991425,0
1,35,1,6,9,8,30028818,0,22261365,19218445,26572702,68052512,2642536,44843037,47485573,0
0,29,1,1,9,3,80076847,0,18417675,22861940,96995949,138275564,99295282,4900703,104195985,0
0,54,0,0,14,5,30028818,0,28912201,22861940,23399979,75174120,26692283,28203066,54895349,0
1,43,1,4,12,5,30028818,0,28912201,22861940,23399979,75174120,26692283,28203066,54895349,0
1,25,1,1,10,5,30028818,0,28912201,22861940,23399979,75174120,26692283,28203066,54895349,0
1,35,1,7,10,9,11611143,0,27354251,16015369,18492033,61861653,1040999,52370258,53411257,0
1,52,1,4,9,7,99789095,1,17648938,24023054,39447928,81119920,22631054,14293718,36924772,1
0,64,0,0,7,1,53384566,0,2033952,22861940,69804512,94700404,53384566,3203074,56587640,0
0,37,1,4,10,6,69399939,0,34192816,22861940,12321044,69375800,63527637,72389473,135917110,0
1,41,1,6,6,5,30028818,0,28912201,22861940,23399979,75174120,26692283,28203066,54895349,0
1,28,1,4,11,6,56053796,0,24343362,80076849,19154955,123575166,25624592,3843689,29468281,0
1,25,1,3,9,5,66730709,0,14573987,22861940,59081459,96517386,66730709,43721962,110452671,0
1,23,1,3,10,5,19218445,1,28347205,22861940,11432496,62641641,18551138,88084536,106635674,1
1,23,1,4,7,5,30028818,1,28912201,22861940,23399979,75174120,26692283,28203066,54895349,1
1,44,1,2,8,5,30028818,0,28912201,22861940,23399979,75174120,26692283,28203066,54895349,0
1,27,1,2,9,4,11904758,0,12251758,22861940,11269672,46383370,2162075,11947466,14109541,0
1,26,1,2,10,4,66730709,1,34433044,22861940,48181631,105476615,90753761,94490685,185244446,1
1,25,1,1,10,5,30028818,0,28912201,22861940,23399979,75174120,26692283,28203066,54895349,0
1,23,1,3,9,5,25624592,0,11386928,22861940,35169754,69418622,2562459,1169122,3731581,0
0,29,1,6,9,5,30028818,0,28912201,22861940,23399979,75174120,26692283,28203066,54895349,0
1,38,0,2,10,3,14947679,0,22549641,22861940,5291745,50703326,18150753,17696983,35847736,0
0,53,0,0,14,5,30028818,0,28912201,22861940,23399979,75174120,26692283,28203066,54895349,0
1,55,0,1,9,3,25090747,0,15534909,22861940,88878059,127274908,15321371,8568223,23889594,0
1,35,1,5,10,6,57722063,0,15134525,22861940,95873627,133870092,47712455,12652143,60364598,0
1,24,1,7,10,8,48046112,0,21941057,80076851,41554736,143572644,48846878,45835987,94682865,0
1,31,1,4,11,6,66730709,0,21780904,22861940,27121646,71764490,49914566,12331835,62246401,0
1,29,1,3,1,5,17416716,0,20980135,22861940,20927399,64769474,31229971,2138052,33368023,0
1,42,0,3,8,4,19084982,1,25784744,48046108,13106084,86936936,13439565,47165264,60604829,1
1,35,1,3,9,5,30028818,0,28912201,22861940,23399979,75174120,26692283,28203066,54895349,0
1,63,1,1,6,3,38370156,0,12652142,22861940,92779984,128294066,38370154,1577514,39947668,0
1,36,1,4,14,6,56053796,0,23350409,96092216,14521478,133964103,12812296,68385628,81197924,0
0,71,0,2,4,3,26692283,0,14573987,22861940,11525537,48961464,26692283,15454832,42147115,0
1,19,1,1,8,5,30028818,0,28912201,22861940,23399979,75174120,26692283,28203066,54895349,0
1,59,1,2,6,5,30028818,0,28912201,22861940,23399979,75174120,26692283,28203066,54895349,0
1,36,0,4,10,6,78742236,0,65663017,22861940,10070598,98595555,501548,83279924,83781472,0
1,41,1,5,9,5,30028818,1,28912201,22861940,23399979,75174120,26692283,28203066,54895349,1
1,45,0,4,1,8,89085493,0,20499673,24023056,12122749,56645478,89085493,18737984,107823477,0
0,47,0,0,1,5,30028818,0,28912201,22861940,23399979,75174120,26692283,28203066,54895349,0
1,33,0,5,7,8,52049952,0,24343363,64061481,45706718,134111562,52049952,17104416,69154368,0
1,19,1,1,10,5,30028818,0,28912201,22861940,23399979,75174120,26692283,28203066,54895349,0
1,64,1,3,14,5,30028818,0,28912201,22861940,23399979,75174120,26692283,28203066,54895349,0
1,26,1,4,14,6,94223757,1,13685133,16015369,99601105,129301607,94223757,2722613,96946370,1
1,19,1,1,10,5,30028818,0,28912201,22861940,23399979,75174120,26692283,28203066,54895349,0
1,22,1,3,9,5,18017291,0,10089683,22861940,38693707,71645330,18017291,72069163,90086454,0
1,46,0,5,9,7,65396094,0,29308127,32030739,22088094,83426960,40524223,36034584,76558807,0
1,27,1,4,10,5,30028818,0,28912201,22861940,23399979,75174120,26692283,28203066,54895349,0
1,37,1,4,9,6,74738393,0,15262648,22861940,20562209,58686797,15161217,46844955,62006172,0
1,68,0,0,1,1,12011528,0,6406148,22861940,31750471,61018559,12011529,34913507,46925036,0
1,30,1,4,10,6,15348064,0,30108896,22861940,10717238,63688074,47378802,35233814,82612616,0
0,57,1,4,14,5,30028818,0,28912201,22861940,23399979,75174120,26692283,28203066,54895349,0
1,23,1,5,9,5,30028818,0,28912201,22861940,23399979,75174120,26692283,28203066,54895349,0
1,19,1,3,9,5,33365355,0,19666875,81678391,14119073,115464339,33365355,39878273,73243628,0
1,24,1,2,3,4,80076849,0,12011527,22861940,10467189,45340656,24023058,53971798,77994856,0
1,24,1,4,11,6,19431982,1,3064541,28827665,31152676,63044882,46658112,79996773,126654885,1
1,28,1,6,8,5,30028818,0,28912201,22861940,23399979,75174120,26692283,28203066,54895349,0
1,53,1,4,8,6,26158438,0,12572066,56053795,1943873,70569734,33098431,76553467,109651898,0
1,27,1,4,10,6,30028818,0,325112,22861940,48846878,72033930,96092218,22901979,118994197,0
1,61,0,0,5,1,53384566,0,10810374,22861940,10167129,43839443,40038424,29147974,69186398,0
1,34,0,5,9,5,30028818,0,28912201,22861940,23399979,75174120,26692283,28203066,54895349,0
1,53,0,3,6,5,26158438,1,20819981,22861940,28028803,71710724,18684598,23302362,41986960,1
1,22,1,3,8,5,66730708,0,1753683,80076849,86296158,168126690,15081141,76873773,91954914,0
1,49,1,5,12,7,2314221,0,33872507,30429203,33320551,97622261,17136446,88084534,105220980,0
1,27,1,4,9,6,72069163,0,1712043,22861940,14565674,39139657,61392255,30269049,91661304,0
0,71,0,3,17,5,24023056,1,88885307,22861940,41101158,152848405,24023058,11210759,35233817,1
1,32,1,6,10,8,17817099,0,27065976,82479156,14398201,123943333,19752291,33792431,53544722,0
1,48,1,0,8,5,30028818,0,28912201,22861940,23399979,75174120,26692283,28203066,54895349,0
1,39,1,5,14,8,24023056,0,18577829,3203074,12072157,33853060,24023058,20980135,45003193,0
1,52,1,2,8,8,15815178,0,10121714,22861940,90948227,123931881,1414691,28026897,29441588,0
1,73,0,0,6,5,30028818,0,28912201,22861940,23399979,75174120,26692283,28203066,54895349,0
1,48,1,5,3,7,17750368,0,20819981,22861940,16817282,60499203,19218447,39718117,58936564,0
1,20,1,1,10,3,26692283,0,28912201,22861940,15189053,66963194,26692283,31229971,57922254,0
1,27,1,4,10,5,30028818,0,28912201,22861940,23399979,75174120,26692283,28203066,54895349,0
1,25,1,2,9,4,1040999,1,20179366,22861940,95600319,138641625,72069163,16335678,88404841,1
1,25,1,4,7,6,24023056,0,14654063,22861940,57848663,95364666,53491335,56854563,110345898,0
1,34,1,4,6,6,13346142,0,21941057,59256868,1871068,83068993,21033521,24023054,45056575,0
1,26,1,3,10,5,52717257,0,41800117,22861940,22411412,87073469,82746077,99295292,182041369,0
1,22,1,4,9,6,26692283,0,40967316,22861940,43729588,107558844,26692283,46925034,73617317,0
1,24,1,5,9,7,39371116,0,18577829,22861940,10354375,51794144,39371116,19827028,59198144,0
1,76,1,0,1,2,18684597,0,16095447,22861940,13186331,52143718,18684597,32671356,51355953,0
1,60,0,0,5,2,64061481,0,52049953,1601537,46544098,100195588,64061475,72069163,136130638,0
1,31,1,4,11,5,30028818,0,28912201,22861940,23399979,75174120,26692283,28203066,54895349,0
1,40,1,8,9,10,17083061,1,20019212,25624592,5765094,51408898,88191299,90006378,178197677,1
1,63,1,3,1,7,1601537,1,1601537,22861940,49474911,73938388,6406148,96092218,102498366,1
0,31,1,2,11,5,30028818,1,28912201,22861940,23399979,75174120,26692283,28203066,54895349,1
0,70,0,0,4,1,41373043,1,96092224,22861940,14537762,133491926,33365355,3203074,36568429,1
1,32,1,4,9,6,1601537,0,7527224,22861940,64687225,95076389,11210759,1231582,12442341,0
1,22,1,1,12,3,30028818,0,14894295,1601537,39077503,55573335,26692283,51249185,77941468,0
1,22,1,1,7,5,30028818,0,28912201,22861940,23399979,75174120,26692283,28203066,54895349,0
1,32,1,5,14,7,1988575,0,23958994,22861940,13779471,60600405,23937639,23382441,47320080,0
1,29,1,5,10,7,13346142,0,29788589,24023054,21655449,75467092,90219917,59465069,149684986,0
1,77,0,0,4,1,30028818,1,28912201,22861940,10118281,61892422,16015369,52850723,68866092,1
1,39,1,0,9,2,37369196,0,47245342,48046108,12444323,107735773,11744604,87283764,99028368,0
1,59,0,1,1,2,21353827,0,12075589,22861940,70362762,105300291,21353827,10890451,32244278,0
1,42,1,4,10,6,98761454,0,11499036,3843689,14177225,29519950,90753756,54516319,145270075,0
1,24,0,1,2,5,30028818,0,28912201,22861940,23399979,75174120,26692283,28203066,54895349,0
1,24,1,4,8,6,26425362,1,35954504,80076847,12735079,128766430,10089684,17616907,27706591,1
1,19,0,0,6,5,30028818,0,28912201,22861940,23399979,75174120,26692283,28203066,54895349,0
1,22,1,2,10,4,24023056,0,89686073,22861940,49544693,162092706,24023058,33392048,57415106,0
0,76,0,2,4,3,28026898,0,11803328,80076847,12874641,104754816,28026898,40038424,68065322,0
0,76,0,0,11,1,66730708,0,60858406,22861940,72107291,155827637,53384566,2162075,55546641,0
1,27,1,5,6,5,30028818,0,28912201,22861940,23399979,75174120,26692283,28203066,54895349,0
1,44,1,6,9,9,74738393,0,13853294,16015369,10269474,40138137,11477681,81678391,93156072,0
1,49,1,4,7,8,24516861,1,32046756,28827665,13559079,74433500,10539447,22982056,33521503,1
1,23,1,2,4,4,12411912,0,26585513,22861940,13642235,63089688,12411912,43481731,55893643,0
1,34,1,2,14,4,10143067,0,25208192,22861940,12339652,60409784,10143068,48526569,58669637,0
1,42,0,5,3,5,30028818,0,28912201,22861940,23399979,75174120,26692283,28203066,54895349,0
1,39,1,6,12,9,81104498,0,39157581,16015369,1770641,56943591,93916788,49647646,143564434,0
1,48,1,4,8,5,30028818,0,28912201,22861940,23399979,75174120,26692283,28203066,54895349,0
1,23,1,2,10,4,30696127,0,60057636,22861940,85761162,168680738,24023058,93689911,117712969,0
1,22,1,3,9,5,10676913,1,19138367,12812296,12711819,44662482,10676913,12812296,23489209,1
1,25,1,3,10,5,19752291,0,1559897,16015369,10099674,27674940,10143068,13372834,23515902,0
1,26,1,2,10,5,30028818,0,28912201,22861940,23399979,75174120,26692283,28203066,54895349,0
1,43,1,1,3,3,53384566,0,18337599,22861940,11795358,52994897,53384566,16335678,69720244,0
1,36,0,5,10,7,40038424,0,13693141,22861940,23399979,59955060,33365355,76873775,110239130,0
1,31,1,4,10,6,52049952,0,26873792,4548365,18247798,49669955,19618828,22741825,42360653,0
1,32,0,4,10,5,30028818,0,28912201,22861940,23399979,75174120,26692283,28203066,54895349,0
1,30,1,6,4,8,90753765,0,5925687,22861940,90483025,119270652,74738393,55413181,130151574,0
1,47,1,2,8,5,30028818,0,28912201,22861940,23399979,75174120,26692283,28203066,54895349,0
1,30,1,1,9,5,30028818,0,28912201,22861940,23399979,75174120,26692283,28203066,54895349,0
1,22,1,1,9,5,30028818,0,28912201,22861940,23399979,75174120,26692283,28203066,54895349,0
1,60,1,2,7,4,85415304,1,38436887,32030739,43496983,113964609,85415304,48046112,133461416,1
1,59,1,0,5,5,30028818,0,28912201,22861940,23399979,75174120,26692283,28203066,54895349,0
1,27,1,5,12,7,11130682,0,36819336,22861940,31824908,91506184,35020279,12508004,47528283,0
1,25,0,2,9,5,30028818,0,28912201,22861940,23399979,75174120,26692283,28203066,54895349,0
1,27,1,2,10,5,30028818,0,28912201,22861940,23399979,75174120,26692283,28203066,54895349,0
1,51,1,4,7,6,24957285,1,16655985,22861940,12897902,52415827,15348063,1040999,16389062,1
1,33,1,3,7,5,30028818,0,28912201,22861940,23399979,75174120,26692283,28203066,54895349,0
1,18,1,3,10,3,30028818,0,1473414,22861940,8548204,32883558,26692283,60858406,87550689,0
1,59,1,1,1,3,36034581,0,73991013,22861940,4099649,100952602,36034581,11210759,47245340,0
1,23,1,2,7,4,1601537,0,66463783,22861940,85272697,174598420,1601537,24503515,26105052,0
1,27,1,2,9,4,13346142,0,24023055,22861940,11781401,58666396,22955362,39157581,62112943,0
1,46,1,5,14,7,32698047,0,27546436,80076851,10740498,118363785,32698047,44843037,77541084,0
1,29,1,5,8,7,66730709,0,26905823,40038424,17352274,84296521,66730709,39397812,106128521,0
1,18,1,1,9,5,30028818,0,28912201,22861940,23399979,75174120,26692283,28203066,54895349,0
1,33,1,4,14,6,34166121,0,13355217,40038424,13521281,66914922,41106119,96092224,137198343,0
1,32,1,2,8,4,30028818,0,84080696,22861940,50591408,157534044,26692283,54452257,81144540,0
1,30,1,5,10,7,53384566,1,38196658,22861940,14049292,75107890,53384566,56053795,109438361,1
1,19,1,2,9,4,40038425,0,1169122,22861940,15258835,39289897,26692283,12796281,39488564,0
0,40,0,2,4,4,47779188,0,45643803,22861940,89343269,157849012,41373043,38757195,80130238,0
1,28,1,5,11,8,30028818,0,67857123,64061478,69362564,201281165,26692283,27594482,54286765,0
1,28,1,4,12,6,53384566,1,30108896,22861940,14635457,67606293,93422995,40278656,133701651,1
0,33,0,1,7,2,30028818,0,35714276,22861940,72223602,130799818,26692283,54452259,81144542,0
1,43,0,1,7,3,16015369,0,584561,80076849,10083391,90744801,16015369,12780265,28795634,0
1,32,1,7,10,9,56053796,0,66463783,22861940,16921954,106247677,18978214,14093526,33071740,0
1,28,1,5,10,7,3683535,0,37876349,96092224,3484411,137452984,46177654,31966679,78144333,0
1,27,1,3,10,5,30028818,0,28912201,22861940,23399979,75174120,26692283,28203066,54895349,0
1,25,1,3,9,5,1601537,0,1169122,22861940,24423439,48454501,1601537,19859058,21460595,0
1,30,0,3,1,4,6406148,0,10249837,22861940,99926758,133038535,6406148,29147974,35554122,0
1,20,1,2,9,4,24023056,0,10409991,60858406,82900131,154168528,80076847,37956429,118033276,0
1,49,1,2,5,4,27359591,1,12652142,22861940,1915728,37429810,28560741,21524658,50085399,1
1,24,1,1,12,3,22688441,0,16127478,22861940,82109283,121098701,22688444,14413833,37102277,0
1,30,1,1,14,3,1134422,0,11370913,24023054,39833465,75227432,91421068,18417675,109838743,0
1,26,1,3,9,5,30028818,0,28912201,22861940,23399979,75174120,26692283,28203066,54895349,0
1,26,1,1,9,3,30028818,0,16736061,22861940,89250221,128848222,16015369,1577514,17592883,0
0,41,0,3,10,4,13079219,0,27386282,22861940,16619571,66867793,45109959,43561806,88671765,0
1,20,1,1,10,5,30028818,0,28912201,22861940,23399979,75174120,26692283,28203066,54895349,0
1,36,0,0,10,3,98761454,0,92088379,22861940,42333961,157284280,76339927,75272241,151612168,0
1,25,1,2,10,4,10676913,0,39301718,22861940,13074681,75238339,17883831,17616907,35500738,0
1,21,1,3,10,5,30028818,0,27098007,22861940,12462932,62422879,19170399,45884033,65054432,0
1,49,1,5,9,11,56053796,0,36114661,736707,82923393,119774761,45376887,38757195,84134082,0
1,59,0,0,7,5,30028818,1,28912201,22861940,23399979,75174120,26692283,28203066,54895349,1
1,59,1,5,12,7,3203074,0,47725803,22861940,99787193,170374936,3203074,34593201,37796275,0
1,33,1,4,10,5,30028818,0,28912201,22861940,23399979,75174120,26692283,28203066,54895349,0
1,36,1,5,10,8,28026898,0,13773218,6406148,61058598,81237964,28026898,18337599,46364497,0
1,41,1,5,9,9,77407622,0,21300443,22861940,16875435,61037818,12865682,24983976,37849658,0
1,25,1,1,9,3,3203074,0,15534909,22861940,14305158,52702007,32030737,96892986,128923723,0
1,36,1,6,14,8,10143067,0,30829587,52850719,14572653,98252959,10143068,56053795,66196863,0
1,72,1,0,9,3,96092218,0,12331835,22861940,7117688,42311463,96092218,68866091,164958309,0
1,34,1,3,10,5,30028818,1,28912201,22861940,23399979,75174120,26692283,28203066,54895349,1
1,44,1,5,1,5,30028818,0,28912201,22861940,23399979,75174120,26692283,28203066,54895349,0
1,21,1,1,10,3,93422991,0,11611143,22861940,11558102,46031185,68278861,19698906,87977767,0
1,25,1,3,8,5,3203074,0,16928246,2722613,12665298,32316157,43241501,25944899,69186400,0
1,30,1,1,14,5,30028818,0,28912201,22861940,23399979,75174120,26692283,28203066,54895349,0
1,20,1,2,10,5,30028818,0,28912201,22861940,23399979,75174120,26692283,28203066,54895349,0
1,20,1,2,10,4,39771502,0,36531058,11210759,16456747,64198564,14387141,17136446,31523587,0
1,35,1,6,6,8,13346142,0,21764888,22861940,14112096,58738924,18471058,24823823,43294881,0
1,25,1,3,9,5,13346142,0,24343362,16928246,38868158,80139766,77674545,325112,77999657,0
1,25,1,1,7,5,30028818,0,28912201,22861940,23399979,75174120,26692283,28203066,54895349,0
1,28,1,4,10,6,23022095,0,15711078,24023054,15506558,55240690,10476722,71588707,82065429,0
1,66,0,0,1,1,12545373,1,42440731,22861940,22562605,87865276,12545372,56534257,69079629,1
1,51,1,1,12,5,30028818,0,28912201,22861940,23399979,75174120,26692283,28203066,54895349,0
1,33,0,4,8,5,20019212,0,81678391,22861940,47855984,152396315,10289875,10730298,21020173,0
